为什么植物会啃石头	为什么植物会石头	1
为什么他把幼儿园的书带回家了	为什么献血不会影响身体健康	0
为什么传说天上有十个太阳	怎样辨别名词、动词和形容词	0
为什么肥皂能清洗手部的脏污	为什么超声波能除脏	0
为什么藕有许多小洞洞	为什么有些植物会指南	0
为什么情绪变化会影响身心健康	为什么中国的许多古建筑上都要雕上龙	0
不同的树过冬方法相同吗	为什么叫姑嫂塔	0
为什么给鸡戴红色眼镜可以多产蛋	什么给鸡戴红色眼镜可以多产蛋	1
为什么称女神峰等景观是三清山三绝	为什么运动后不想立即吃饭	0
为什么有的墙用空心砖来砌	为什么马戏团的小狗能算算术	0
为什么汽车玻璃和家用玻璃不一样	为什么汽车玻璃和家用玻璃不一样	1
洒水车上的水桶为什么不做成方的或圆形的	为什么勾践能够报仇雪耻	0
为什么血是红色的	为什么血是红色的	1
为什么青少年不宜经常开夜车	无线电波能在水下传播吗	0
为什么有的坦克能在陆地和水中行使	阿尔瓦德岛为什么叫美人岛	0
为什么东乡族过春节与畲族不同	为什么不要把桔子皮扔掉	0
为什么说树叶是最简易的吹奏乐器	为什么我国北方海岸大多比较平直，南方海岸比较弯曲	0
为什么叫马跑泉	为什么叫马跑泉	1
为什么泥鳅要吐泡	为什么泥鳅要吐泡	1
为什么侗族人管程阳桥叫做风雨桥	为什么成熟的水果会变色	0
为什么中国有那么多种地方戏曲	为什么国有那么多种地方戏曲	1
为什么导弹靠近目标才引爆	!!·你知道满族的礼节和禁忌吗	0
为什么曹冲能知道大象的重量	为什么人工流产会导致不孕	0
为什么说美术可以提高观察能力	为么说美术可以提高观察能力	1
谢安为什么要批评哥哥	为什么情绪变化会影响身心健康	0
为什么人一哭就会流鼻涕	为什么说太阳是太阳系的家长	0
什么是磁悬浮列车	为什么用x表示未知数	0
为什么蓖麻籽不能吃	有的沿海岛屿降水为什么比邻近大陆还少	0
为什么蜻蜓要点水	为什么铁特别容易生锈	0
猫为什么要捉老鼠	猫为什么要捉鼠	1
为什么端午节吃粽子	为什么端节吃粽子	1
为什么哈密瓜特别甜	为什么哈密瓜特别甜	1
为什么星星有不同的颜色	为什么常眨眼可能是病	0
为什么千岁兰也可以称为沙漠章鱼	!·壮族有些什么礼仪与禁忌	0
为什么要提倡背诵一些精美的文学作品	螃蟹为什么横着走	0
为什么小熊猫总长不大	为什么同一个玉米棒上会有不同颜色的粒	0
为什么要提倡平衡膳食	为什么要提倡平衡膳食	1
为什么月亮不会发光却是明亮的	为什么米仓口里流出许多好大米	0
为什么蜜蜂蜇人后自己也会死掉	为什么蜜蜂蜇人后自己也会死掉	1
为什么看鱼鳞能知道鱼的年龄	阿尔瓦德岛为什么叫美人岛	0
为什么人吸进氧气，呼出时变成了二氧化碳	为什么人吸进氧气，呼出时变成了二氧化碳	1
为什么有的鱼离开水不会死	花灯是流行于哪些民族中的民间歌舞	0
什么是武器的战斗性能	什么是武器的战斗性能	1
为什么有的鱼离开水不会死	为什么有的鱼离水不会死	1
为什么不要生吃杏的种仁	为什么不要生吃杏的种仁	1
为什么空气并不空	为什么空气并不空	1
为什么千岁兰也可以称为沙漠章鱼	为什么千岁兰也可以称为沙漠鱼	1
活树建筑为什么倍受青睐	高空的气温为什么低	0
为什么火车上不能收听广播，却能打手机	为什么蹲久了站起来就会头晕眼花	0
为什么蚂蚁不上床了	为什么说埃及是尼罗河的赠礼	0
为什么别府温泉首屈一指	为什么太阳月亮会跟着人走	0
为什么彩虹的七色顺序总是不变	放大镜是怎样把物体放大的	0
为什么在黑暗中看不见东西	为什么在暗中看不见东西	1
电风扇能降低室温吗	为什么鸡和鸭有翅膀却飞不高呢	0
为什么花有大小美丑之分	为什花有大小美丑之分	1
为什么彩虹的七色顺序总是不变	为什么彩虹的七色顺序总是不	1
花灯是流行于哪些民族中的民间歌舞	花灯是流行于哪些民族中的民间歌舞	1
拉祜族是怎样过扩塔节的	拉祜族怎样过扩塔节的	1
为什么鸟飞行时要把两腿藏在身下	为什么齐桓公被称为春秋五霸之首	0
为什么饮绿茶能消除口臭	为什么饮绿能消除口臭	1
!·为什么冬季玻璃杯会炸	!·为什么冬玻璃杯会炸	1
什么是航天飞机，它在军事上有哪些用途	为什么有的鸟腿上套有一个金属环	0
为什么说白血球是人体卫士	为什么说白血球是体卫士	1
为什么三四岁幼儿讲故事，常常需要手势、动作来描述	为什么会出现开元盛世	0
为什么萌萌向爸爸要香烟盒	为么萌萌向爸爸要香烟盒	1
!·为什么人们喜欢看孔雀舞	胖人下滑的速度会比瘦人更快吗	0
地球是怎样形成的	为什么说隋炀帝有功有过	0
为什么它是世界上最小的鸟	为什么它是世界上最小的	1
为什么说我国是世界上盐湖最多的国家	为什么说我国是世界上盐湖最多的国家	1
为什么一幅好画不能随意改动	为什么要适当地吃粗粮	0
儿童画为什么不一定是儿童画的	人在空中为什么不能再跳第二次	0
四书五经包括哪几部书	四书五经包括几部书	1
为什么婴儿生下来就会哭	为什么狗在热天爱伸出舌头	0
鱼雷是怎样击中目标的	为什么要开发组合食品	0
为什么晚上卧室里不宜多放花草	为什么成人不要搂着孩子睡觉	0
冥王星与其它各行星有什么不同	!·为什么佤族人吃烂饭份饭	0
为什么夏天星星比冬天多	为什么夏天星星比冬天多	1
为什么鱼泉会有那么多的鱼	为什么鱼泉会有那么多的鱼	1
为什么把有的乐队叫交响乐队	为什么小佳佳会盛气凌人	0
为什么不能吃死鳝鱼	为什么说漳州是水仙之乡	0
为什么切开的茄子放久了表面发黑	为什么临碑帖对提高书法水平能起很大作用	0
为什么三四岁幼儿讲故事，常常需要手势、动作来描述	什么三四岁幼儿讲故事，常常需要手势、动作来描述	1
为什么有的墙用空心砖来砌	为什么翼龙能在空中飞行	0
人们六次登上月球在那里都发现了什么	为什么在树枝上睡觉的鸟不会掉下来	0
老虎洞中为什么没有老虎	为什么称孔夫子是圣人	0
为什么电风扇能使人感到凉快	为什么萧遥欣要劝朋友爱护鸟	0
为什么昆虫没有鼻子却嗅觉灵敏	为什么昆虫没有鼻子却嗅觉灵敏	1
中国人为什么特别钟爱丹顶鹤	中国人为什么特别钟爱丹顶鹤	1
狗为什么要抬腿撒尿	螃蟹为什么横着走	0
冷水和热水哪个沸腾快	冷水和热水哪个沸腾快	1
为什么恒星会发光	为什么恒会发光	1
为什么有的人分辨不出颜色	为什么有的分辨不出颜色	1
为什么马德堡半球实验能证明压强的存在	露是怎样形成的	0
人为什么会出汗	人为什么会汗	1
饺子或肉丸煮熟了为什么会浮起来	饺子或肉丸煮熟了为什么会浮起来	1
为什么山洞有冷暖之分	为什么把足球称为世界第一运动	0
为什么人工流产会导致不孕	为什么闪电可怕而雷并不可怕呢	0
为什么怒族人用溜索过河	为什么跳芭蕾舞要立起脚尖	0
为什么张汤让驴主人两天内不要喂驴	为什么泥鳅要吐泡	0
为什么桂林山水如此奇丽秀美	为什么桂林山水如此奇丽秀美	1
山洞为什么被叫做东海龙宫	山洞为什么被叫做东海龙宫	1
为什么称女神峰等景观是三清山三绝	为什么称女峰等景观是三清山三绝	1
为什么计算机病毒武器比核武器更厉害	为什计算机病毒武器比核武器更厉害	1
谁是夏朝第一位国君	卓别林为什么能成为喜剧大师	0
为什么说植物的种子是大力士	为什么说植物的种子是力士	1
为什么鱼的身上会有黏液	胖人为什么更易饥饿	0
为什么英国的法官和律师要戴假发	为什么英国的法官和律师要假发	1
被遗弃在太空的尸体最终会怎样	为什么广州也叫羊城	0
为什么澳大利亚被称为骑在羊背上的国家	为什么澳大亚被称为骑在羊背上的国家	1
红潮有什么危害	红潮有什么危害	1
高空的白雾带是怎样形成的	为什么蚯蚓是植物的好朋友	0
!·为什么冬季玻璃杯会炸	为什么铅球的重量是7.257千克	0
人们为什么喜欢到盘山游览	内弹道学的定义及任务是什么	0
为什么蓖麻籽不能吃	为什蓖麻籽不能吃	1
为什么用冷水洗脸能预防感冒	为什么闪电可怕而雷并不可怕呢	0
为什么塑料有的坚硬，有的柔软，有的像海绵	为什么地球上三极臭氧层破坏严重	0
为什么金刚石最坚硬	为什么金刚石最坚硬	1
为什么肥皂能清洗手部的脏污	为么肥皂能清洗手部的脏污	1
华富里为什么又叫猴城	绘画大家庭中为什么会有漫画	0
为什么轰炸机被称做天空杀手	为什么说拉斐尔的西斯廷圣母是最美的圣母像	0
为什么门前有西瓜苗	什么是驱逐舰	0
人为什么会发笑	人为什么会发笑	1
为什么鸸鹋又叫长跑健将	为什么鸸又叫长跑健将	1
为什么飞鱼会飞	怎样使用漂白粉	0
为什么云彩不会掉下来	海鸥为什么总追着轮船飞	0
为什么螃蟹要横着走	为什么飞镖的尖鼻子先落地	0
火车头能做得轻便些吗	火车头能做得轻便些	1
为什么要在花盆里放些空蛋壳	为什么称女神峰等景观是三清山三绝	0
为什么花也要睡觉	为什么花也要睡觉	1
为什么门镜又被称作警眼	为什么东西扔上去总会落下来	0
为什么幼儿喜欢拆卸玩具	为什么要使用不同的谱号	0
为什么表演快板书要边说边打竹板	为什么人有头皮屑	0
为什么叫姑嫂塔	为什么春节要敲锣打鼓放鞭炮	0
常规潜艇为什么不能长时间在水下	塔吉克族是怎样过迄脱迄迪尔节的	0
为什么沙发比一般椅子松软有弹性	为什么罂粟被称为有毒植物之王	0
为什么在黑暗中看不见东西	为什在黑暗中看不见东西	1
为什么王羲之被奉为书圣	论语是孔子写的吗	0
为什么火箭和飞机的头部是尖的	为什么兄弟们不再争吵了	0
电风扇能降低室温吗	电风扇能降室温吗	1
为什么鱼缸里的水草会冒泡	为什么会出现战国七雄	0
为什么乌龟身上会出汗	为什么高速飞行需设置特殊的跳伞装置	0
为什么铅笔伸进水就像是断了	为什么铅笔伸进水就像是断了	1
为什么花瓣都特别漂亮	为什么测量山的高度要以海平面为标准	0
大蒜为什么能抑菌	大蒜为什么能抑菌	1
为什么导弹能自动跟踪活动的目标	为什么水族阿姨喜欢在衣裤上绣花边	0
为什么孩子肚子疼不能随便吃止疼药	为什么不赞成青少年饮酒	0
山谷的风是怎样形成的	山的风是怎样形成的	1
为什么会出现腰椎间盘突出	为什么说能在做游戏的过程中积累词汇	0
太阳为什么会有太阳黑子	为什么火箭要垂直发射	0
注射青霉素前为什么要做皮试	注射霉素前为什么要做皮试	1
为什么面对幼儿做示范动作时应镜面示范	为什么面对幼儿做示范动作应镜面示范	1
为什么李爱民能智送鸡毛信	为什么哈密瓜特别甜	0
被疯狗咬伤怎么办	被疯狗咬伤怎么办	1
为什么经常参加锻炼能使胖人消瘦，能使瘦弱的人变得壮实	为什么经常参锻炼能使胖人消瘦，能使瘦弱的人变得壮实	1
为什么说四川省的铁树林是我国最大的铁树林	为什么说四川省的铁树林是我国最大的铁树林	1
为什么山洞有冷暖之分	为什么山洞有冷之分	1
如何把洗衣机改成洗碗机	为什么火焰山至今还有唐僧的拴马桩	0
为什么光可窃听	为什么平平眼睛里的水满了	0
为什么巨杉是 世界巨木之首	为什么投降举白旗	0
为什么蒙娜·丽莎的微笑有永恒的魅力	为什么人造卫星环绕地球的轨道不一样	0
为什么布依族人喜欢用鸭头鸭脚待客	为什么布依族人喜欢用鸭头鸭脚待客	1
熊为什么冬眠？冬眠为什么不脱水	为什么在黑暗中猫能捉到老鼠	0
为什么火箭炮能够布雷	为什么火炮能够布雷	1
你好吗	什么是单音词、复音词	0
为什么明明是画却要叫素描	为什么种子煮熟后就不能发芽	0
为什么计算机能够发送传真	为什么计算机够发送传真	1
积累词汇有哪些途径	怎样除去镜片上的水雾	0
人在空中为什么不能再跳第二次	什么树比钢还硬	0
为什么地球在转，而我们却感觉不到	火车汽笛为什么变化?浅谈多普勒效应	0
北京时间取自哪里	北京时间取自哪里	1
为什么小朋友不要多吃油炸的食物	为什么吃饭时看书不好	0
为什么常喝鸡汤有助于治疗皮肤病	火星上有生命吗	0
为什么我国各民族都有传统乐器，你知道是什么吗	为什么我国各族都有传统乐器，你知道是什么吗	1
为什么狮子大王收到的是一袋水	阿昌族为什么要过尝新节、撒种节及耍白象	0
为什么说狂草书法起于张、成于素	为什么要淘汰氟里昂	0
高空的气温为什么低	为什么说墨不一定是黑的	0
红糖结块怎么办	为什么合理的膳食应当荤素搭配	0
为什么翼龙能在空中飞行	为什么翼龙能在空飞行	1
为什么土家族要给大公鸡献花	为什么土家族要给公鸡献花	1
什么是生物战剂	什么是生物战剂	1
什么是全球定位系统	为什么流星会从天上掉下来	0
为什么荷叶遇雨结水珠	湿袜子为什么粘脚	0
为什么星星有不同的颜色	为什么说商纣王是著名的大暴君	0
为什么无声手枪是无声的	反装备武器有哪些	0
为什么坦克也能够用于扫雷	为什么坦克也能够用于扫雷	1
为什么马戏团的小狗能算算术	什么马戏团的小狗能算算术	1
为什么宰相管李泌叫小友	为什么宰相管李泌叫小友	1
什么是空间武器	什么是空间武器	1
爆炸时寂静区是怎样形成的	为什么有的音乐叫激光音乐	0
为什么有的表要上弦才走，有的表不上弦也走	为什么幼儿经常自言自语	0
在月经期做劈叉、倒立等活动对身体有害吗	给电池充电要先放掉剩余的电，对吗	0
为什么冬季夜空中的星星比夏季少	为什么冬季夜中的星星比夏季少	1
为什么花有大小美丑之分	为什么花有大小美丑之分	1
为什么胃液是酸的	什么是激光雷达	0
为什么叫它拳头木偶	为什么用硬笔书写也称书法	0
为什么说地球里面不是厚厚的土	为什么电影中受伤的镜头像真的一样	0
为什么瓶子草是食虫的最特殊的植物	为什么瓶子草是食虫的最特殊的物	1
为什么毛笔要用动物身上的毛来做	怎样培养你的音乐细胞	0
电扇转快时为什么象在倒转	为什么电冰箱有时嗡嗡响	0
为什么海豹喜欢吃石块	俄罗斯族有什么礼仪及禁忌	0
为什么乌孜别克族家家门口挂花门帘	为什么乌孜别克族家家门口挂花帘	1
为什么要给孩子打预防针	为什么塔塔尔族人参加宴请时要带勺子	0
为什么激光武器有很强的杀伤力	为什么湿煤封火害处大	0
为什么叫神光山	为什么人站在地球上掉不下来	0
你知道门巴族有哪些礼仪及禁忌吗	为什么冬天会有霜	0
为什么毒蛇的肉也可以吃	为什么蛇的舌头总是伸出来	0
为什么把唐代上釉的陶器被称做唐三彩	为什么把唐代上釉的陶器被称做唐三彩	1
为什么鲸类有流眼泪的习性	为什么植物会啃石头	0
为什么情绪变化会影响身心健康	为什么情绪变化会影响身心健康	1
为什么人站在地球上掉不下来	为什么匡衡要凿壁借光	0
为什么说书法可以体现人的品格与智慧	为什么有闪电和雷声	0
红场为什么不能算世界上最大的广场	红场为什么不能算世上最大的广场	1
为什么蚯蚓没有腿和脚却会行走	为么蚯蚓没有腿和脚却会行走	1
为什么纸是文房四宝中的一宝	日本庆祝男孩节为什么要挂鲤帜	0
为什么母鸡下蛋后要咯咯地叫	天为什么是蓝色的	0
水开后摸壶底,烫手吗	水开后摸底,烫手吗	1
为什么彩色胶卷能拍出彩色照片	为什么运动场上要穿钉子鞋	0
为什么南海的小岛数也数不清	为什么植物喜欢找气味相投的朋友	0
北京时间取自哪里	北京时间自哪里	1
香蕉果实里有种子吗	香蕉果实里有种子吗	1
为什么幼儿喜欢拆卸玩具	为什么幼儿喜欢拆卸玩具	1
为什么鸟类有偷东西的嗜好	为什么鸟类有偷东西的嗜好	1
为什么叫虎门	为什么叫虎门	1
为什么鹅兵会作战	为什么鹅兵会作战	1
为什么会形成各式各样的岛屿	云是怎样形成的	0
积累词汇有哪些途径	为什么易拉罐能变成小工艺品	0
排球运动是怎样产生的	人们为什么喜欢到盘山游览	0
为什么脑子会越用越灵	为什么脑会越用越灵	1
为什么柿子有的甜、有的涩	跳雷为什么会跳	0
你知道魏晋南北朝时期的志怪轶事小说吗	为什么植物会有形形色色的根	0
为什么鱼会跳出水面	为什么鱼会跳出水面	1
为什么外国影片中的人物也说的是中国话	纳西族有哪些礼仪和禁忌	0
为什么小手指变成了大拇哥	为什么浓甘油不宜搽脸	0
为什么布朗族人喜欢嚼茶、嚼烟	为什么布朗族人喜欢嚼茶、嚼烟	1
为什么维维含着泪又笑了	为什么海豹喜欢吃石块	0
宇宙是怎样形成的	为什么让硕硕当小炊事员，他才高兴剥豆豆	0
果树为什么有大小年	果树为么有大小年	1
为什么有些植物会指南	为什么有的花香，有的花臭	0
为什么有的树能自己长出来	为什么有时会收到乱码的电子邮件	0
针灸为什么能治病	为什么有两个西湖	0
为什么行星轨道都近似地位于一个平面	为什么行轨道都近似地位于一个平面	1
为什么说螺是建筑奇才	吃带鱼要去鳞吗	0
为什么数码相机不使用胶卷	放大镜是怎样把物体放大的	0
热是什么	热是什么	1
圣文森特角为什么有天涯海角之称	为什么月亮有时大，有时小，有时明，有时暗	0
为什么磕头虫会磕头	为什么自行车比赛选手要走之字形路线	0
为什么刚接的自来水盆里有许多气泡	神舟号飞船为什么选在晚上发射	0
为什么用湿布抹冰箱的冰格会被粘着	为什么说我国古代气象观测的水平很高	0
羊多利是怎样被制造出来的	羊多利是怎样被制造出来的	1
为什么传统办法可以对付卫星侦察	为什传统办法可以对付卫星侦察	1
荧火虫为什么会发光	荧火虫为什么会发光	1
为什么刘勰夜晚要到佛殿读书	为什么话剧演员要必修音乐课	0
为什么矮果树产量高	为什么矮果树产量高	1
为什么故宫是最大的宫殿	为什么故宫是最大的宫殿	1
冰川是如何形成的	为什么把从我国到古罗马国的路称作丝绸之路	0
为什么千岁兰也可以称为沙漠章鱼	为什么跳芭蕾舞要立起脚尖	0
为什么汽车玻璃和家用玻璃不一样	儿童画为什么不一定是儿童画的	0
宝宝为什么总流口水	什么是空地导弹	0
独龙族是怎样过卡秋哇节的	独龙族是怎样过卡秋哇节的	1
为什么月亮朝着地球那一面是不变的	布依族的六月六、四月八是怎么回事	0
为什么会爆发安史之乱	为什么会爆发安史之乱	1
飞船最佳发射窗口是怎样确定的	为什么苗族人要过龙船节	0
为什么人体的左右不对称	为什么人体的左右对称	1
为什么磨刀不误砍柴工	为什么磨刀不误砍柴工	1
为什么黑人父母会生出纯白宝宝	为什么月亮上很荒凉	0
为什么范正平要走着上学，却不肯骑马、坐轿	为什么水滴能在荷叶上滚来滚去	0
为什么昆虫没有鼻子却嗅觉灵敏	为什么昆没有鼻子却嗅觉灵敏	1
为什么人一哭就会流鼻涕	为什么韩愈买来一根蜡烛	0
热是什么	热是什么	1
为什么在野外也能辨别出方向	为什么画画要画得满	0
地磁场变化吗,它变化会有什么影响	地磁场变化吗,它变化会有什么影响	1
为什么卫星能观察到地面的情况	为什么丁丁知道排队了	0
什么是景泰蓝艺术	为什么摄像机摄像时不需要对焦和曝光	0
为什么子女与父母之间会产生代沟	为什么人会生病	0
为什么练完体操后比练习时气喘得厉害	山谷的风是怎样形成的	0
为什么人有脉博	为什么人有脉博	1
为什么从冷气间走出来，眼镜会模糊一片	为什么测量山的高度要以海平面为标准	0
冬季为什么用湿手接触铁器时会被粘住	积累词汇有哪些途径	0
为什么水仙花喝清水就能生长开花	为什么水仙花喝清水就能生长开花	1
什么是反义词	什么是反义词	1
水晶眼镜养目吗	水晶眼镜目吗	1
为什么管这种熊又叫浣熊	为什么管这种熊又叫浣熊	1
为什么新疆被称为瓜果之乡	为什么新疆被称为瓜果乡	1
你知道傈僳族有哪些礼仪和禁忌吗	为什么有的植物能连生在一起	0
冥王星为什么是岩石型行星	冥王星为什么是岩石型行星	1
为什么要限制儿童看电视	什么要限制儿童看电视	1
冥王星与其它各行星有什么不同	冥王星与其它各行星有什么同	1
为什么大蒜能杀菌	音乐为什么是人生活中的亲密伴侣	0
什么是鱼雷艇	为什么跑步比赛要逆时针跑	0
星系会互相吞并吗	刚出锅的鸡蛋为什么不烫手	0
为什么现代通信要利用卫星	为什么有的蘑菇不能吃	0
宝宝为什么总流口水	宝宝为什么总流口水	1
为什么去畲族人家进门有三道关	为什么扁平足对孩子有影响	0
男人与女人的身体有什么差别	男人与女人的身体有什么差别	1
这里为什么有世界最大的鳄鱼动物园	为什么北极星会指方向	0
为什么郭翻受到大家的敬重	什么郭翻受到大家的敬重	1
哈哈镜照人为什么会变样	为什么物体的重量会变	0
为什么说乌鸦是灭害的功臣	为什么称喊瀑和喊雨	0
为什么纳西族人也过火把节	为什么西族人也过火把节	1
为什么捕蝇草是最奇特的草	为什么毛泽东把饭让给小朋友吃	0
为什么康县令判郗珍无罪	为什么康县令判郗珍无罪	1
为什么独龙族人都吃大锅饭	地球为什么会自转	0
为什么星星、月亮不会掉下来	做早操有什么好处	0
为什么听自己录音会觉得声音变了	花生为什么又叫落花生	0
大气可分为哪几层	为什么水面上的汽油是彩色的	0
生长着的花、果香味为什么与采摘下的不同	生长着的花、果香味为什么与采摘下的不同	1
白族人有哪些礼仪和禁忌	白族人有哪些礼仪和禁忌	1
为什么说吴昌硕是开启一代画风的画家	为什么海水又咸又苦	0
为什么说埃及金字塔是古代文明史上的奇迹	为什么说埃及金字塔是古代文明史上的奇迹	1
脾气和脾有关吗	为什么幼儿好动，不易约束自己	0
为什么喷气式飞机烧煤油而不烧汽油	飞机上为什么禁用手机	0
为什么说我国是茶叶的故乡	为什么说我国是茶叶的故乡	1
有的沿海岛屿降水为什么比邻近大陆还少	为什么有些建筑物样子特别怪	0
为什么建筑物会是多种多样的	白族人有哪些礼仪和禁忌	0
动物为什么不会迷失方向	干冰所产生的白雾是什么东西	0
人为什么能感到鲜味	为什么有些植物散发的气味令人感到清爽	0
为什么大理石有各种各样的颜色	为什么大理石有种各样的颜色	1
为什么梅花鹿身上的梅花会变	冥王星为什么是岩石型行星	0
露是怎样形成的	是怎样形成的	1
为什么墨是文房四宝中的一宝	为什么墨是文四宝中的一宝	1
为什么茶树都生长在南方	冬至为什么吃饺子	0
为什么跳水有空中芭蕾之称	为什么房间里洒了水会凉快些	0
为什么鱼缸里的水草会冒泡	为什么蟒河那么迷人	0
为什么雨天电话容易串音	为什么马德堡半球实验能证明压强的存在	0
为什么小狗睡觉时要将耳朵贴在地上	额不里海滩为什么是旅游的好地方	0
为什么花有大小美丑之分	为什么花有大小美丑之分	1
彗星为什么有尾巴	月亮上是什么样的	0
!·为什么几片云彩会把整个太阳遮住	!·为什么几片云彩会把整个阳遮住	1
为什么火山会喷发	为什么蛇的舌头总是伸出来	0
收音机为什么会有杂音	为什么桂林山水如此奇丽秀美	0
为什么兵马俑坑是名胜古迹	为什么红脸的母鸡会生蛋	0
为什么已排除的化学地雷应运到安全地点处理	海牛是一种什么动物	0
排球运动是怎样产生的	排球运动是怎样产生的	1
为什么蜜蜂蜇人后自己也会死掉	为什么蜜蜂蜇人后自己也会死掉	1
为什么有些孩子爱吃泥土、砖头、烂纸、墙皮等	月亮为什么沿着奇怪的轨道绕地球转	0
为什么雨点有大有小	什么是反卫星武器	0
山洞为什么有冷也有热	山洞为什么有冷也有热	1
用什么办法寄那些怕摔碰、怕雨淋的东西	用什么办法寄那些怕碰、怕雨淋的东西	1
地球为什么是球形的	什么是黑客	0
为什么星星、月亮不会掉下来	为什么猴岛成为旅游中的一个热点	0
古城为什么定名为无锡	古城为么定名为无锡	1
为什么有的树叶秋天会变红	为什么葡萄会爬架子	0
为什么反坦克地雷是坦克的克星	为什么兔子的耳朵很长	0
纳西族有哪些礼仪和禁忌	纳西族有哪些礼仪和禁	1
为什么会有独头蒜	我国的黄土高原上为什么常年覆盖着黄土	0
为什么吃菠萝时蘸盐水	为什么菠萝时蘸盐水	1
为什么阴天时看不见太阳	为什么螺是建筑奇才	0
卡普里岛为什么又叫野猪岛	为什么中国画常把彩色的东西画成黑白的	0
为什么人在剧烈活动后不能马上停下来	为什么白天能看见太阳，晚上看不见太阳	0
为什么星星会发光	为什么称巴西是足球王国	0
烧开水时为什么有声音	烧水时为什么有声音	1
怎样使肥皂一物多用	为什么焦尾琴的尾部有烧焦的痕迹	0
为什么仡佬族人要给牛过生日	为什么香蕉里看不到种子	0
·!!·为什么方承观立志苦学	狐为什么会给人留下诡计多端的印象	0
为什么大多数人右手的力气比左手大	为什大多数人右手的力气比左手大	1
雷达是怎样探测目标的	雷达是怎探测目标的	1
为什么合理的膳食应当荤素搭配	什么合理的膳食应当荤素搭配	1
飞机上为什么禁用手机	为什么动物要有保护色	0
为什么说徐悲鸿是中国美术界的一代宗师	为什么水星上没有大气层	0
蚂蚁从高处落下为什么摔不死	打哈欠会传染吗	0
为什么毒蛇和无毒蛇长得不一样	为什么毒蛇和无毒蛇长得不一样	1
为什么孟母三次搬家	为什么孟母三次搬家	1
为什么彩虹的七色顺序总是不变	为什么小艾虎能打得过大老虎	0
为什么洗衣机能洗干净衣服	荆轲为什么要刺杀秦王	0
为什么成熟的水果会变色	什么是微声手枪	0
为什么太阳也会死亡	大爆炸是黑洞吗	0
什么叫干画法和湿画法	为什么生物武器令人感到恐怖	0
什么是护卫舰	你知道人声有哪些类别吗	0
为什么山上的松树特别多	为什么吃菠萝时蘸盐水	0
为什么毛南族人喜欢毛南三宝	为什么毛族人喜欢毛南三宝	1
为什么我国北方春天会从天上下黄土	!·为什么寒冷的冬天鸟也不怕冷	0
白族人有哪些礼仪和禁忌	为什么鱼的身上会有黏液	0
为什么要用鼠标	什么要用鼠标	1
为什么人体的左右不对称	为什么人体的左右不对称	1
为什么有些城市的电话号码特别长	为什么王允之要故意装醉	0
为什么纳西族人也过火把节	为什么纳西族人也过火把节	1
!·壮族有些什么礼仪与禁忌	!·壮族有些什么礼仪与禁忌	1
景颇族有什么礼仪及禁忌	潜水艇为什么能上浮和下沉	0
为什么哈密瓜特别甜	为什么说与学习音乐相比，学习美术更适合少年儿童的特点	0
为什么许衡不肯摘梨解渴	为什么衡不肯摘梨解渴	1
为什么生白薯没有烤白薯甜	为什么生白薯没烤白薯甜	1
为什么已排除的化学地雷应运到安全地点处理	为什么说与学习音乐相比，学习美术更适合少年儿童的特点	0
为什么日军要偷袭珍珠港	为什么日军要偷袭珍港	1
为什么小海马不是海马爸爸生的	为什么小海马是海马爸爸生的	1
为什么医生要使用听诊器	为什么医生要使用听诊器	1
仡佬族是怎样过仡佬年的	为什么兵马俑坑是名胜古迹	0
为什么世界上第一把小提琴是埃及的音乐家莫可里制造的	为什么说小行星是恐龙灭绝的元凶	0
为什么制导炮弹能精确打击目标	为什么制导炮弹能精确打击目	1
为什么植物的种子能无脚走遍天下	为什么矮果树产量高	0
为什么奔跑时心脏会剧烈跳动	为什么奔时心脏会剧烈跳动	1
为什么被称为盐湖之家	为什被称为盐湖之家	1
为什么运动后不想立即吃饭	为什么运动后不想立即吃饭	1
为什么青少年不宜经常开夜车	为什么廷廷认不出那只泥猫了	0
为什么航空母舰能载飞机	谢安为什么要批评哥哥	0
为什么小明选择了雪	为什么明选择了雪	1
为什么说钟繇是楷书之祖	你知道人声有哪些类别吗	0
为什么花有大小美丑之分	为什么久坐久站脚会发麻	0
为什么油棕有世界油王的美称	斑马身上的花纹有什么用	0
为什么人工流产会导致不孕	为什么地雷壳要采用塑料制成	0
为什么范正平要走着上学，却不肯骑马、坐轿	为什么范正平要走着上学，却不肯骑马、坐轿	1
飞机为什么能飞	为什么珊珊小朋友午睡时不上床	0
珊瑚为什么这样美	为什么登山被称为勇敢者的运动	0
为什么月亮上不能住人	为什么录像机能自动录像	0
宇宙是怎样形成的	为什么登山被称为勇敢者的运动	0
为什么叫磨针井	水杉是名副其实的世界爷吗	0
为什么录像机能自动录像	为什么丁丁知道排队了	0
为什么叫木偶戏	为什么盆栽花要换盆	0
为什么太阳给我们带来光和热	剪了指甲为什么还会长	0
为什么航空母舰能载飞机	为什么鳄鱼不属于鱼	0
为什么孙子兵法被誉为 兵学鼻祖 	什么是词义的扩大和缩小	0
飞机里新鲜空气哪里来	飞机里新鲜空气哪里来	1
为什么人们不能直接吃河豚	为什么千岁兰也可以称为沙漠章鱼	0
给电池充电先要放掉剩余的电，对吗	给电池充电先要放掉剩余的电，对吗	1
为什么蚊子喜欢穿深色衣服的人	为什么说猩猩最聪明	0
为什么说电脑毕竟不能代替人脑	为什么蒙古族人要吃团圆饼	0
什么是宽带	为什么水槽的下水管常做成弯曲的	0
为什么望远镜能使我们看清远处的东西	为什么望远镜能我们看清远处的东西	1
什么是小舌	为什么跑步比赛要逆时针跑	0
为什么患肾炎的人仍能参加体育活动	为什么患肾炎的人仍参加体育活动	1
怎样使肥皂一物多用	为什么他们能走过水坑	0
为什么说秦始皇是中国第一个皇帝	为什么说秦始皇是中国第一个皇帝	1
为什么电影中受伤的镜头像真的一样	为什么电影中受伤的镜头像真的一样	1
为什么不倒翁始终不倒	为什么不倒翁始终不倒	1
铅球出手的角度应该是多少	彗星为什么有尾巴	0
为什么千岁兰也可以称为沙漠章鱼	为什么鲸不是鱼	0
为什么王育要卖身赔羊	为什么孝文帝要改制	0
为什么梅花鹿身上的梅花会变	数字化部队有哪些优势	0
为什么墨是文房四宝中的一宝	为什么天空是蓝色的	0
为什么南非被称为黄金之乡	影碟上常见镭射，究竟镭在哪儿，会损害人体吗	0
猪为什么用嘴巴拱泥土	猪为么用嘴巴拱泥土	1
牛蛙的肤色为什么会改变	牛蛙的肤色为什么会改变	1
为什么夏天人的皮肤上容易长出小红点	为什么夏天人的皮上容易长出小红点	1
为什么传说天上有条银河	为什么蓄电池能蓄电	0
为什么有鸟床	为什么傣族人喜欢住竹楼	0
什么是词义的扩大和缩小	什么是词义的扩大和缩小	1
为什么端午节那天要吃粽子、赛龙舟	为什么有人唱歌声音沙哑	0
雾是怎样形成的	雾是怎样形成	1
为什么让硕硕当小炊事员，他才高兴剥豆豆	为什么数星星的孩子能成为天文学家	0
为什么肉汤凉得较开水慢	人们六次登上月球在那里都发现了什么	0
为什么咖啡能提神醒脑	为什么天空中会出现流星	0
为什么门前有西瓜苗	为什么门前有西瓜苗	1
冰为什么这么滑	为什么仡佬族人要给牛过生日	0
为什么有的飞机翼尖向上折起	为什么有飞机翼尖向上折起	1
什么是太阳风	什么是太阳风	1
为什么水果不都是甜的	为什么水果不都是甜的	1
高空的白雾带是怎样形成的	高空的白雾带是怎样形成的	1
命题作文为什么要认真审题	命题作文为什么要认审题	1
为什么蒙古族人要吃团圆饼	为什么蒙古族人要吃团圆饼	1
为什么蔬菜的味道不一样	为么蔬菜的味道不一样	1
为什么纸盒做的小火车能拐弯	为什么纸盒做的小火车能拐弯	1
为什么画画要画得满	为什么有的坦克能在陆地和水中行使	0
为什么火车到站后，工人要用锤子在车下敲打	为什么火车到站后，工人要用锤子在车下敲打	1
为什么古莲子为我国寿命最长的种子	为什么古莲子为我国寿命最长的种子	1
拉祜族是怎样过扩塔节的	为什么海水无色而大海蓝色	0
为什么陈毅把墨当糖吃了	动物能听懂音乐吗	0
为什么在野外也能辨别出方向	为什么和尚念经敲的木鱼也是一种乐器	0
为什么孙康要在雪地里读书	为什么说猩猩最聪明	0
你能让铅笔尖向下直立在手指上吗	为什么意大利被称为旅游之国	0
为什么海豹不睡大觉	为么海豹不睡大觉	1
为什么人造卫星环绕地球的轨道不一样	为什么人造卫星环绕地球的道不一样	1
为什么翼龙能在空中飞行	为什么翼龙能在空中飞行	1
为什么蔬菜的味道不一样	为什么太阳给我们带来光和热	0
为什么鄂温克族人喜欢驯鹿	为什么鄂温克族人喜欢驯鹿	1
为什么说中国是风筝的故乡	为什么叫木偶戏	0
为什么要建国际空间站	为什么刚接的自来水盆里有许多气泡	0
为什么仡佬族人要给牛过生日	海菊花为什么不是花	0
炸药的威力为什么会很大	人为什么会变老	0
!·为什么几片云彩会把整个太阳遮住	!·为什么几片云彩会把整个太阳遮住	1
为什么有的鸟腿上套有一个金属环	大熊猫人工授精怀孕为什么都是双胞胎	0
为什么吃水果也要适量	为什么牛吃完草后还不停地咀嚼	0
为什么大多数人右手的力气比左手大	为什么有的飞机翼尖向上折起	0
为什么荷叶遇雨结水珠	为什么叶遇雨结水珠	1
为什么要给星星取名字	为什么不让皇帝看起居注	0
为什么卫卫给老师厉害的回击	被遗弃在太空的尸体最终会怎样	0
为什么俄罗斯族人用面包和盐迎接客人	为什么俄罗斯族人用面包和盐迎接客人	1
吃带鱼要去鳞吗	为什么他们能顺利通过独木桥	0
为什么叫胜棋楼	为什么用硬笔书写也称书法	0
为什么海娃把鸡毛信放在羊尾巴下	为什么海娃把鸡毛信放在羊尾巴下	1
什么是空地导弹	不同的树过冬方法相同吗	0
为什么吴道子的作品被称作吴带当风	为什么吴道子的作被称作吴带当风	1
为什么砚是文房四宝中的一宝	为什么浓甘油不宜搽脸	0
雾凇和雨凇是怎样形成的	什么是黑客	0
为什么有些建筑物样子特别怪	为什么冷饮不可多吃	0
为什么跳蚤有惊人的跳跃本领	为什么跳蚤有惊人的跳跃本领	1
什么是布雷舰	为什么狼的眼睛会闪闪发光	0
神舟七号为什么选择夜间发射	达尔文海湾为什么是鸟天下	0
怎样培养你的音乐细胞	胃切除后为什么还能消化食物	0
为什么眼睛能看到东西	为什么日食发生在初一而不是十五	0
为什么李时珍从小立志学医	为什么花盆底部有个小洞	0
为什么从冷气间走出来，眼镜会模糊一片	为什么从冷气间走出来，眼镜会模糊一片	1
为什么可以用吸管喝汽水	为什么可以用吸管喝汽水	1
为什么晚上捕鱼用灯能引诱鱼群	为什么晚上捕鱼用灯能引诱鱼群	1
为什么用流动的水洗手比用盆里水洗手效果要好	火箭和导弹是一回事吗	0
为什么睡觉时不要蒙着头	为什么幼儿好动，不易约束自己	0
为什么体操运动员要在手上涂白色粉末	为什体操运动员要在手上涂白色粉末	1
为什么反坦克地雷是坦克的克星	为什么反坦克地雷是坦克的克星	1
为什么达斡尔族人爱往脸上抹黑	为什么达斡尔人爱往脸上抹黑	1
为什么会发生918事变	为什么会发生18事变	1
珊瑚为什么这样美	为什么鱼要有鱼鳔	0
为什么短命菊是植物中生命最短的	为什么瑶族人庆祝达努节	0
为什么太阳也会死亡	为什么鱼雷能在海中不同深度上航行	0
为什么壁虎能在墙上爬却不掉下来	为什么跳蚤有惊人的跳跃本领	0
为什么鲸不是鱼	为什么鲸不鱼	1
为什么天上会飘雪花	为什么天上会飘雪	1
中国画为什么要装裱	为什么航空母舰能载飞机	0
人为什么会上火	人为什么会上火	1
为什么蛇的舌头总是伸出来	流星雨怎么形成的	0
为什么天空会呈现不同的颜色	为什么天空会呈现不同颜色	1
打哈欠会传染吗	打哈欠传染吗	1
为什么建筑物会是多种多样的	为什么建筑物会是多种样的	1
为什么树会发出笑声	为什么蟋蟀会用翅膀唱歌	0
为什么小手指变成了大拇哥	为什么怒族人用溜索过河	0
为什么黄花菜要晒干以后才能吃	为什么黄花菜要晒干以后才吃	1
为什么一幅好画不能随意改动	为什么没煮熟的豆浆不能喝	0
什么是景泰蓝艺术	什么是景泰蓝艺术	1
为什么门镜又被称作警眼	为什么有些磺胺类药要与小苏打合用	0
为什么地球会绕轴自转	什么地球会绕轴自转	1
为什么从冷气间走出来，眼镜会模糊一片	美国的导弹防御计划是怎样的	0
为什么叫胜棋楼	为什么满族人糊抹了油的窗纸	0
不同的树过冬方法相同吗	不同的树过冬方法相同吗	1
为什么说隋炀帝有功有过	为什么说隋炀帝有有过	1
为什么星星、月亮不会掉下来	为什么说鲸的身上样样都是宝	0
为什么录像机能自动录像	为什么要使用信用卡	0
为什么鄂温克族人的仓库里不放熊皮	为什么重阳节要登高	0
!·为什么几片云彩会把整个太阳遮住	为什么称唐伯虎是江南第一风流才子	0
为什么说数学起源于结绳计数和土地丈量	为什么说数学起源于结绳计数和土地丈量	1
为什么蜘蛛能织网	植物怎样对付昆虫的蚕食	0
为什么孙登要放掉背弹弓的青年	为什么要淘汰氟里昂	0
为什么地球内部可以分成许多圈层	为什么有人唱歌声音发抖	0
为什么萌萌拆半导体	为什么萌萌拆半导体	1
为什么电视剧和电影要有导演	为什么电视剧和电影要有导演	1
为什么月亮朝着地球那一面是不变的	怎样使肥皂一物多用	0
为什么水是无色的，雪却是白色的	为什么有的海洋会发光	0
为什么有些孩子爱吃泥土、砖头、烂纸、墙皮等	为什么黄花菜要晒干以后才能吃	0
为什么抑制乙烯的生成和作用，可以贮藏保鲜	为什么抑制乙烯的生成和作用，以贮藏保鲜	1
为什么水仙花喝清水就能生长开花	为什么中国有那么多种地方戏曲	0
为什么说应该提倡幼儿双手并用	常吃钙片为什么也会缺钙	0
使用车用汽油要注意什么	为什么鱼泉会有那么多的鱼	0
圣克劳德为什么叫做烟斗之城	为什么向日葵的花总是朝着太阳	0
为什么火箭和飞机的头部是尖的	为什火箭和飞机的头部是尖的	1
白族人有哪些礼仪和禁忌	白族人有哪些礼仪和禁忌	1
为什么地毯式轰炸是战争中一张王牌	为什么在家里就可以网上购物	0
雷达有哪些战术技术性能	雷达有哪些战术技术性能	1
为什么磁卡电话能自动计费	有头上长角的鱼吗	0
为什么李时珍从小立志学医	为什么说让婴儿多爬有许多好处	0
为什么内蒙古举行那达慕大会时那么热闹	为什么鲸类有流眼泪的习性	0
为什么禁放烟花爆竹	鄂温克族是怎样过米阔鲁节的	0
彝族人民为什么要过火把节	彝族人民为什么要过火把节	1
为什么莎莎唱歌喜欢用小沙锤来伴奏	为什么莎莎唱歌喜欢用小沙来伴奏	1
沙漠是怎样形成的	为什么满族人糊抹了油的窗纸	0
如何自制粘蚊蝇纸条	为什么有的小朋友容易患驼背	0
为什么生活在贝壳里的动物叫软体动物	为什么有的湖水会分层	0
为什么阿昌族人喜欢户撒刀	什么阿昌族人喜欢户撒刀	1
为什么小草长得特快、特别多	为什么小狗睡觉时要将耳朵贴在地上	0
海水会越来越咸吗	为什么平平眼睛里的水满了	0
为什么反坦克地雷是坦克的克星	为什么反坦克地雷是坦克的克星	1
成卷的塑料薄膜展开时为什么会吸引毛发	成卷的塑料薄膜展开时为什么会吸引毛发	1
为什么叫太阳海岸	中国画为什么要装裱	0
云是怎样形成的	为什么短跑运动员要下蹲起跑	0
为什么保安族叔叔喜欢在腰间系一把保安刀	为什么保安族叔叔喜欢在腰间系一把保安	1
你知道傈僳族有哪些礼仪和禁忌吗	你知道傈僳族有哪些礼仪和禁忌吗	1
为什么睡觉时不要蒙着头	飞机为什么能飞	0
为什么大连的贝雕最好	为什么大连的贝雕最好	1
为什么苍耳的果实老往人身上粘	为什么苍耳的果实老往人身上	1
为什么怪石被称为大象石	为什么不用纯酒精消毒	0
为什么战斗机被称作空中霸王	为什么战斗机被称作空中霸王	1
鲁迅为什么要塑造阿Q这个人的形象	鲁迅什么要塑造阿Q这个人的形象	1
为什么他能揭开细腰蜂变化的秘密	为什么他能揭开细腰蜂变化的秘密	1
为什么鸟的歌声特别婉转动听	论语是孔子写的吗	0
为什么我国北方春天会从天上下黄土	常吃钙片为什么也会缺钙	0
在什么条件下，月球会变成淡红色	为什么计算机病毒武器比核武器更厉害	0
为什么冬天鸭子在水里不怕冷	为什么放大镜不能把角放大	0
为什么把有的乐队叫交响乐队	为什么把有的队叫交响乐队	1
为什么古莲子为我国寿命最长的种子	为什么古子为我国寿命最长的种子	1
跳高运动员为什么要助跑	为什么大雁要排成一字或人字形队伍飞行	0
为什么王献之的母亲说他练字三千日，只有一点像羲之	为什么极光出现在地球两极	0
为什么大熊猫是国宝	为什么奥运会以五色环为标志	0
为什么保安族叔叔喜欢在腰间系一把保安刀	为什么保安族叔叔喜欢在腰间系一把保安刀	1
青蛙的大嘴巴有什么用	青蛙的大嘴巴有什么用	1
为什么植物会啃石头	为什么有淡水鱼和盐水鱼之分	0
自行车是怎样加速运动和刹车的	自行车是怎样加速动和刹车的	1
为什么说人类离不开植物的光合作用	人们为什么喜欢到盘山游览	0
汽油的90#、93#、97#是什么意思	为什么指出自己缺点的朋友是好朋友	0
为什么幼儿教育小学化的方式会降低幼儿大脑功能	为什么不要空腹喝牛奶	0
为什么叫摇篮曲	为什么鹅兵会作战	0
火星上有生命吗	为什么冰块能漂在水面上	0
火箭是怎样飞上天的	火箭怎样飞上天的	1
你知道声乐演唱有哪些形式吗	你知道声乐演唱有哪些形式吗	1
什么是余音绕梁，三日不绝	什么是余音绕梁，三日不绝	1
怀孕后为什么要少吃米饭	为什么生白薯没有烤白薯甜	0
火车票剪后有什么用	少数民族是怎样巧用箭毒树的	0
为什么幼儿厌恶这位抽烟的阿姨	为什么幼儿厌恶这抽烟的阿姨	1
分子发动机很小有多小	人为什么能感到鲜味	0
为什么娜娜会把幼儿园的积木拿回家	什么娜娜会把幼儿园的积木拿回家	1
怎样使肥皂一物多用	怎样使皂一物多用	1
为什么鱼要有鱼鳔	为什么很多人喜欢听轻音乐	0
什么是反卫星武器	为什么火箭要垂直发射	0
在什么条件下，月球会变成淡红色	你好吗	0
北京时间取自哪里	为什么会有独头蒜	0
为什么子女与父母之间会产生代沟	为什么子女与父母之间会产生代沟	1
怎样使鸡肉更鲜美	为什么叶子两面的颜色深浅不同	0
为什么油着火不能用水灭	为什么潜艇在水下能认路	0
为什么四面环水的地方叫岛屿	为什么去畲族人家进门有三道关	0
为什么要照顾年龄小的伙伴儿	为什么蟒河那么迷人	0
为什么冬天暖房要开窗子	水杉是名副其实的世界爷吗	0
为什么燕子低飞要下雨	为什么燕子低飞要下雨	1
为什么反坦克地雷是坦克的克星	为什么称老舍为人民艺术家	0
为什么地球上有那么多山	为什么地球上有那么多山	1
为什么迫击炮能击中遮蔽物后的目标	为什么树木要修剪	0
为什么老奶奶要磨铁棒槌	为什么有的柑桔没有核	0
核能是一种安全可靠清洁的能源吗	核能是一种安全可靠清洁的能源	1
世界上为什么会有五光十色的湖	世界上为么会有五光十色的湖	1
什么叫姑娘追	什么叫姑追	1
为什么土族人都喜欢戴毡帽	为什么他能把小铁球够上来	0
为什么李世民会发动玄武门之变	为什么李世民会发动玄武门之变	1
为什么朝鲜族人住的房子没窗户	为什么朝鲜族人住的房子没窗户	1
为什么说书法可以体现人的品格与智慧	为什么说书法可以体现人的品格与智慧	1
为什么树叶在天冷的时候会掉下来	为什么树叶在天冷的时候会掉下来	1
狂犬病是怎么回事	为什么有的植物能连生在一起	0
蚂蚁从高处落下为什么摔不死	为什么会发生海啸	0
为什么幼儿不会听反话	小孩为什么要唱儿童歌曲不要唱大人歌曲	0
为什么核检查有不同的方法	为什么核检查有不同的方法	1
怎样使服装挺括	怎样使服装括	1
为什么红脸的母鸡会生蛋	为什红脸的母鸡会生蛋	1
为什么B超能诊断疾病	核潜艇和普通潜艇的区别是什么	0
为什么不能给花浇凉开水	为什么罐装的自动喷剂喷了一会罐身会变凉	0
为什么墨是文房四宝中的一宝	为什么墨是文房四宝中的一宝	1
杂技演员为什么能用牙齿挂着一个人	为什么海水无色而大海蓝色	0
为什么王允之要故意装醉	秋天为什么大雁往南飞	0
为什么蓖麻籽不能吃	为什么信息能够共享	0
为什么蚯蚓是植物的好朋友	为什么廷廷认不出那只泥猫了	0
为什么有人管西瓜叫卡拉哈里沙漠中的球	为什么耳朵最怕冷	0
为什么要照顾年龄小的伙伴儿	为什么要照顾年龄小的伙伴儿	1
为什么寄居蟹和海葵是好朋友	为什么已受外力作用的地雷应就地销毁	0
为什么核大战会产生核冬天	为什么地雷壳要采用塑料制成	0
宝宝为什么总流口水	为什么酸奶小杯能称出物体的重和轻	0
为什么指出自己缺点的朋友是好朋友	为什么土族人都喜欢戴毡帽	0
为什么有些城市的电话号码特别长	为什么把有的乐队叫交响乐队	0
为什么小孩不能吃补品补药	什么小孩不能吃补品补药	1
为什么用流动的水洗手比用盆里水洗手效果要好	为什么用流动的水洗手比用盆里水洗手效果要好	1
什么是词义的扩大和缩小	什么是词义的扩大和缩小	1
你知道傈僳族有哪些礼仪和禁忌吗	为什么说我国是世界上盐湖最多的国家	0
为什么小草帽风铃很漂亮	为什么会有鼓，鼓有什么用	0
为什么紧张运动后,肌肉会抽搐	为什么紧张运动后,肌肉会抽搐	1
为什么有些磺胺类药要与小苏打合用	什么是微光夜视仪	0
为什么睡前要用热水洗脚	为什么在黑暗中猫能捉到老鼠	0
如何自制粘蚊蝇纸条	如何自制粘蚊蝇纸	1
大豆为什么被称为豆中之王	为什么头发会脱落	0
珊瑚为什么这样美	瑚为什么这样美	1
为什么短跑运动员穿上钉子鞋参加比赛时跑得就快	雨是怎样形成的	0
为什么水星上没有大气层	为什么画画时会用眼睛比会用手更重要	0
你知道土族有哪些礼仪和禁忌吗	植物的种子和果实会爬行吗	0
为什么花有各种不同的颜色	为什么地毯式轰炸是战争中一张王牌	0
为什么月球总是以固定的一面对着地球	有的沿海岛屿降水为什么比邻近大陆还少	0
语文的含义是什么	语文的含义是什么	1
人为什么会出汗	为什么会出汗	1
为什么射击后未爆的炮弹不许乱动	为什么要用鼠标	0
为什么有人唱歌声音沙哑	为什么有人歌声音沙哑	1
洒水车上的水桶为什么不做成方的或圆形的	洒水车上的水桶为什么不做成方的或圆形	1
为什么银杏树有活化石之称	为什么鱼缸里的水草会冒泡	0
为什么冬天孩子的手和脸容易皴裂	为什么包拯被称为铁面包公	0
为什么新疆是我国最大的瓜果生产基地	为什么新疆是我国最大的瓜果生产基地	1
拔河比赛只是比力气吗	拔河比赛只是比力气吗	1
为什么高尔夫球上有坑	爆炸时寂静区是怎样形成的	0
为什么海豹不睡大觉	为什么收音机在晚上收台比白天多	0
天为什么是蓝色的	为什么停车信号用红色	0
胫骨前痛是怎样引起的	胫骨前痛是怎样引的	1
为什么说有办法能把海水里的盐去掉	为什么人要睡觉	0
为什么手枪用布包起来不好	为什么手枪用布包起来不	1
为什么火焰山至今还有唐僧的拴马桩	应该怎样在现场急救溺水者	0
为什么人可以听见声音	为什么人以听见声音	1
铁锤为什么砸不坏肚子	铁锤为什么砸不坏肚子	1
为什么竹子长得特别快	为什么飞机要装红绿灯	0
为什么水果不都是甜的	为什么水果不都是甜的	1
为什么说药补不如食补	为什么三脚架重机枪的火线越高射弹散布面积越大	0
使用车用汽油要注意什么	为什么毒蛇的肉也可以吃	0
为什么短跑运动员经常拉伤大腿后面的肌肉	为什么叫木偶戏	0
为什么叫姑嫂塔	工艺美术为什么会包括许许多多的内容	0
拔河比赛只是比力气吗	拔河比赛只是比力气吗	1
为什么藏族人要在同一天到河里洗澡	什么是绿色冰箱	0
为什么内蒙古举行那达慕大会时那么热闹	为什么内蒙古举行那达慕大会时那么热闹	1
为什么被蜜蜂螫刺后，皮肤的红肿和疼痛会不断加剧	为什么长吻鱼喜欢接吻	0
鹞式战斗机为什么能垂直起降	鹞式战斗机为什么能垂直起降	1
强盗为什么会吓得仓惶逃窜	为什么制导炮弹能精确打击目标	0
为什么聪明的贝贝不会区分各种几何图形	哈尼族有什么礼仪及禁忌	0
为什么不能单从字面上去理解成语的含义	为什么叫墨池	0
蜡染在哪些民族中流行	蜡染在哪些民族中流行	1
为什么合理的膳食应当荤素搭配	为什么青少年不宜经常开夜车	0
为什么中国有那么多种地方戏曲	为什么把花的叶子摘了，花就死了	0
为什么眼镜蛇发怒时脖子会变粗	为什么有的植物开花，有的植物不开花	0
为什么哈萨克族人喜欢冬不拉	你知道羌族有哪些礼仪和禁忌	0
为什么木星有小太阳系的美称	为什么木星有小太阳系的美称	1
旋转球为什么不走直线	转球为什么不走直线	1
为什么竹子开花后会死	为什么红灯停，绿灯行	0
为什么要用手掂一掂	什么要用手掂一掂	1
世界四大水果是哪几种	猫为什么爱用爪子洗脸	0
为什么台球运动被称为力学魔术师的表演	为什么台球运动被称为力魔术师的表演	1
人为什么要经常眨眼	为什么包拯被称为铁面包公	0
为什么人有脉博	为什么细嫩的幼苗能拱动石板	0
畲族有什么礼仪及禁忌	甘遂为什么开绿花	0
为什么要把自来水塔都造得很高	为什么纺锤树可以提供自来水	0
为什么数码相机不使用胶卷	有些坦克炮的抽烟装置为什么偏置	0
为什么古莲子为我国寿命最长的种子	为什么焦尾琴的尾部有烧焦的痕迹	0
贝加尔湖口为什么会立有一块大圆石	为什么要提倡平衡膳食	0
为什么熟鸡蛋能竖立旋转	为什么熟鸡蛋竖立旋转	1
为什么树木要修剪	为什么木要修剪	1
你知道高山流水的故事吗	如何打开锈锁	0
为什么人们不能直接吃河豚	为什么人们不能直接吃河豚	1
为什么不能用沙子去扑灭燃烧的炸药	脑袋大的人一定聪明吗	0
怎样才能把这四样东西分开	为什么芳芳变了	0
为什么计算机的时钟在断电时仍能正常工作	为什么计算机的时钟在断电时仍能正常工作	1
为什么相声要引人发笑	为什么相要引人发笑	1
为什么吃了没煮熟的扁豆会中毒	为什么薄薄的圆纸片能立起来	0
为什么蝴蝶可以做到没有声音得飞舞	为什么捕蝇草是最奇特的草	0
为什么彩色照片时间久了会褪色	为什么毛南族人喜欢毛南三宝	0
为什么幼儿喜欢拆卸玩具	为什么幼儿喜欢拆卸玩具	1
运动的物体为什么都存在惯性	运动的物体为什么都存在惯性	1
为什么睡觉要向右侧卧	为什么睡觉要向右侧卧	1
蠡园为什么是中外游人迷恋的地方	为什么雷雨时，先看到闪电，后听到雷声	0
为什么微光电视可以进行战场监视	为什么鸡和鸭有翅膀却飞不高呢	0
为什么说他是聪明的小皇帝	地空导弹的目标搜索与指示及制导系统各有什么特点及作用	0
为什么有的植物开花，有的植物不开花	为什么有的植物开花，有的植物不花	1
为什么颐和园里的铜牛没有尾巴	为什么颐和园里的铜牛没有尾巴	1
谁是最有影响的发明人	为什么英国的法官和律师要戴假发	0
荆轲为什么要刺杀秦王	纳西族有哪些礼仪和禁忌	0
为什么用扇子扇炉火越扇越旺，而扇蜡烛却一扇就灭	为什么李时珍从小立志学医	0
为什么阴天湖水会冒泡、变浑	为什阴天湖水会冒泡、变浑	1
为什么植物会啃石头	为什么死金鱼肚子向上翻	0
有头上长角的鱼吗	为什么天空会呈现不同的颜色	0
为什么叫民歌	黑白电视机为什么能收看彩色电视节目	0
为什么短命菊是植物中生命最短的	为什么久坐久站脚会发麻	0
为什么禹凡突然不愿来幼儿园	为什么禹凡突然不愿来儿园	1
为什么冬季夜空中的星星比夏季少	什么是和平号空间站	0
为什么说墨不一定是黑的	为什么说墨不一定是黑的	1
为什么老奶奶要磨铁棒槌	为什么步枪口径越来越小	0
为什么有的海洋会发光	贝加尔湖口为什么会立有一块大圆石	0
为什么傣族人喜欢住竹楼	为什么会出现一屋跨两国的情况	0
樱花为什么被称为日本的国花	樱花为什么被称为日的国花	1
为什么说要用心去观察	卓别林为什么能成为喜剧大师	0
什么是星云	为什么坦克也可以架桥开路	0
为什么新疆被称为瓜果之乡	为什么新疆被称为瓜果之乡	1
为什么称老舍为人民艺术家	·!!·为什么方承观立志苦学	0
什么是单音词、复音词	为什么罂粟被称为有毒植物之王	0
为什么大雁要排成一字或人字形队伍飞行	中国古代有街道树吗	0
!·壮族有些什么礼仪与禁忌	为什么勤奋读书可以陶冶性情	0
谁是最有影响的发明人	为什么金刚石最坚硬	0
冰川是如何形成的	为什么蚂蟥具有医学用途	0
为什么不宜带幼儿到公共场所活动	V字手势的来源是什么	0
冥王星为什么是岩石型行星	为什么叫姑嫂塔	0
为什么打电话会有回声	墙皮为什么会出汗	0
为什么说美国是年轻的国家	为什么说美国是年轻的国家	1
为什么不能吃死鳝鱼	为什么不能吃死鳝鱼	1
为什么植物有酸、甜、苦、辣的味道	为什么狗在热天爱伸出舌头	0
为什么人会做梦	为什么人会做梦	1
红潮有什么危害	红潮什么危害	1
为什么晚上捕鱼用灯能引诱鱼群	为什么植物会有形形色色的根	0
老虎滩的老虎为什么卧在海中	虎滩的老虎为什么卧在海中	1
为什么竹子开花后会死	电视图像为什么会出现重影	0
阿尔瓦德岛为什么叫美人岛	密度计的刻度为什么是不均匀的	0
人是被电吸住了吗	人是被电吸住了吗	1
武器为什么会出汗	为什么人要睡觉	0
缺钙者为什么会抽筋	钙者为什么会抽筋	1
为什么苗族人要过龙船节	为什么说树叶是最简易的吹奏乐器	0
怎样煮蛋不爆	怎样煮蛋不	1
熊为什么冬眠？冬眠为什么不脱水	熊为什冬眠？冬眠为什么不脱水	1
为什么红比拉鱼被称为危险动物	为什么坦克也可以架桥开路	0
为什么有人把可可树称作软黄金	为什么火焰山至今还有唐僧的拴马桩	0
为什么煤层中会有琥珀	为什么煤层中会有琥珀	1
为什么流星会从天上掉下来	为什么流星会从天上掉下来	1
为什么吃冰淇淋要适可而止	为什么吃冰淇淋要适可而止	1
小朋友唱的歌曲为什么有前奏和间奏	为什么金沙江畔会有醉汉林	0
为什么说太阳离我们很远很远	为什么不让皇帝看起居注	0
为什么茶树都生长在南方	为什么茶树都生在南方	1
阅读中碰到不懂的文言词汇该怎么办	阅读中碰到不懂的文言词汇该怎办	1
为什么铝不容易生锈	为什么铝不容易生锈	1
为什么说药补不如食补	为什么说甜橙和橘子不一样	0
为什么已受外力作用的地雷应就地销毁	为什么已受力作用的地雷应就地销毁	1
为什么雅鲁藏布江谷地有地热资源	为什么雅鲁藏布江谷地有地热资源	1
为什么海豹喜欢吃石块	为什么海豹喜欢吃石	1
为什么王安石要变法	为什么王安石要变法	1
被遗弃在太空的尸体最终会怎样	为什么要从小预防近视眼	0
为什么说应该提倡幼儿双手并用	为什么说太阳离我们很远很远	0
为什么匡衡要凿壁借光	为什么知了的鸣叫声显得单调刺耳	0
为什么小伙计能成为大画家	为什么小伙计能成为大画家	1
为什么显微镜能看到微观世界	为什么石灰岩洞中会生长着石笋和钟乳石	0
为什么薄荷是清凉的	为什么薄荷是清凉的	1
为什么咖啡能提神醒脑	彗星为什么有尾巴	0
为什么计算机的时钟在断电时仍能正常工作	为什计算机的时钟在断电时仍能正常工作	1
为什么北京有那么多有名和好玩的地方	为什么彗星都拖条尾巴	0
为什么互联网上要设立防火墙	为什么太监要往蜜坛子里放老鼠屎	0
经常吃生鸡蛋的人为什么会使头发早白	经常吃生鸡蛋的人为什么会使头发早白	1
为什么鳄鱼不属于鱼	为什鳄鱼不属于鱼	1
为什么要坚持写片断	为什么傈僳族要过刀竿节	0
为什么曹冲能知道大象的重量	为什么佤族人都随身带着筒帕	0
为什么说太阳离我们很远很远	什么叫姑娘追	0
为什么说喜马拉雅山是从海里升起来的	为什么说喜马拉雅山从海里升起来的	1
怎样使笔尖好用	为什么冬天的西红柿不如夏天的好吃	0
为什么计算机也会生病	为什么计机也会生病	1
为什么说毛毛虫是杨树的花	为么说毛毛虫是杨树的花	1
为什么胃液是酸的	为什么胃液是酸的	1
为什么螃蟹要吐沫	为什么树会发出笑声	0
电流通过人体吗	为什么说要用心去观察	0
水杉是名副其实的世界爷吗	水杉是名副其实的世界爷吗	1
为什么领港鱼不怕大鲨鱼	高空的气温为什么低	0
怎样使鸡肉更鲜美	怎样使鸡肉更鲜美	1
军用弹药的组成部分有哪些	为什么都夸鄂伦春族人心眼好	0
植物的种子和果实会爬行吗	炸药的威力为什么会很大	0
额不里海滩为什么是旅游的好地方	为什么韩德常老师是幼儿音乐教育家!·和幼儿作曲家	0
为什么打电话会有回声	为么打电话会有回声	1
为什么耶路撒冷被称为圣城	为什么耶路撒冷被称为圣城	1
为什么伤口愈合时会觉得痒	为什么红色印泥不易褪色	0
什么是巡洋舰	什么是巡舰	1
杂技演员为什么能用牙齿挂着一个人	杂技演员为什么能用牙齿挂着一个人	1
肥皂泡的大小如何变	肥皂泡的大小如何变	1
!·为什么几片云彩会把整个太阳遮住	!·为什么几片云彩会整个太阳遮住	1
为什么内蒙古举行那达慕大会时那么热闹	什么是军用机器人	0
为什么每天锻炼也消耗不完人的体力	为什么鸟类有偷东西的嗜好	0
为什么抑制乙烯的生成和作用，可以贮藏保鲜	为什么箭毒木又叫见血封喉树	0
什么是脉冲星	为什么跑弯道的时候要内倾	0
为什么小佳佳会盛气凌人	为什么肖思话决心改恶从善	0
为什么狗睡觉时把嘴藏在前肢下	为什么睡觉时把嘴藏在前肢下	1
做早操有什么好处	为什么说鲸的身上样样都是宝	0
为什么眼镜蛇发怒时脖子会变粗	为什么眼镜蛇发怒脖子会变粗	1
为什么直升机要装长尾巴	樱花为什么被称为日本的国花	0
爆炸时寂静区是怎样形成的	为什么人的皮肤会有不同的颜色	0
什么是星云	为什么岳柱对名画提出批评	0
什么是宽带	油画为什么要用油来调颜色	0
为什么海龟会流泪	沙漠是怎样形成的	0
为什么病毒可致人于死地	为什么红比拉鱼被称为危险动物	0
!·为什么佤族人吃烂饭份饭	什么是步枪	0
为什么苗族有四月八这个节日	为什么苗有四月八这个节日	1
为什么血能在人体中流动	为什么要提倡背诵一些精美的文学作品	0
佤族有哪些礼仪和禁忌	为什么月经期不能游泳	0
男孩子为什么爱意气用事	为什么叫磨针井	0
为什么植物会有形形色色的根	为什么金沙江畔会有醉汉林	0
为什么基诺族人喜爱竹子	为什么鹅兵会作战	0
为什么火箭要垂直发射	为什么说冬冬是个讲信用的好孩子	0
为什么人站在地球上掉不下来	为什么芳芳变了	0
为什么隐形飞机会隐身术	人在真空中会怎样	0
为什么磁盘可以保存信息	什么叫一次能源和二次能源	0
为什么睡前要用热水洗脚	为什么幼儿教育小学化的方式会降低幼儿大脑功能	0
人是怎样消化食物的	人是怎样消化食物	1
为什么茜茜没举手	为什么茜茜没举手	1
为什么火车上不能收听广播，却能打手机	为什火车上不能收听广播，却能打手机	1
彗星会撞上地球吗	星会撞上地球吗	1
为什么内蒙古举行那达慕大会时那么热闹	魔鬼谷里的草为什么茂盛	0
为什么说大陆漂移形成了现在的地形构造	为什么火山会爆发	0
为什么地球会绕轴自转	为什么地球会绕轴自转	1
为什么每天锻炼也消耗不完人的体力	为么每天锻炼也消耗不完人的体力	1
为什么要用Email	为什么不宜带幼儿到公共场所活动	0
为什么舌头能尝出味道来	为什么狼的眼睛会闪闪发光	0
什么树比钢还硬	么树比钢还硬	1
独龙族是怎样过卡秋哇节的	夜晚的天空为什么是黑的	0
为什么说颜体被称为楷书第一家	中国古代有街道树吗	0
为什么要淘汰氟里昂	月亮为什么沿着奇怪的轨道绕地球转	0
哈尼族有什么礼仪及禁忌	什么是隐形手枪	0
为什么东西扔上去总会落下来	为什么红色印泥不易褪色	0
为什么小飞虫总爱在灯下飞来飞去	为什么小飞虫总爱在灯下来飞去	1
蜡烛为什么能被吹灭	你知道世界上最大的核潜艇吗	0
针灸为什么能治病	为什么黄鳝小时候是雌性，长大了却是雄性	0
为什么超声波能除脏	世界上为什么会有五光十色的湖	0
为什么不要躺着看书	为什么粥烧开了会溢出来	0
花粉长什么样呢	为什么松树会产生松脂	0
为什么恒星会发光	为什么恒星会发光	1
为什么会出现日食和月食现象	什么会出现日食和月食现象	1
为什么桥都设计成凸形的	月亮为什么沿着奇怪的轨道绕地球转	0
笔杆上的小孔有什么功用	笔杆上的小孔有什功用	1
为什么地球又叫蓝色的星球	为什么地球又叫蓝色的星球	1
为什么蟋蟀会用翅膀唱歌	谁是夏朝第一位国君	0
什么是微光夜视仪	什么是微光夜视仪	1
火星上有生命吗	大炮能把卫星送上天吗	0
新生儿乳房肿大为什么不能挤	新生儿乳房肿大为什么不能挤	1
你知道魏晋南北朝时期的志怪轶事小说吗	你知道魏晋南北朝时期的志怪轶事小说吗	1
哪些锻炼项目有助于矫正八字脚	为什么做事要细心	0
为什么把家春秋称为现代红楼梦	为什么把家春秋称为现代红楼梦	1
鄂伦春族过春节与赫哲族有什么不同	为什么仡佬族人要给牛过生日	0
为什么海龟和乌龟不一样	为什么猫的眼睛一日三变	0
为什么水星上没有水	为什么手枪用布包起来不好	0
为什么地球是圆的而地面是平的	为什么地球是圆的而地面是平的	1
为什么说响水不开，开水不响	怎样清扫水泥地	0
为什么说美国是年轻的国家	为什么说美国是年轻的国	1
为什么计算机也会生病	八个电池是怎样连接的	0
为什么马的耳朵时常摇动	为什么马的耳朵时常摇动	1
为什么刘勰夜晚要到佛殿读书	为什么刘勰夜晚要到殿读书	1
为什么汽车玻璃和家用玻璃不一样	为什么汽车玻璃和家用玻璃不样	1
雷达有哪些战术技术性能	雷达有哪些战术技术性能	1
为什么小伙计能成为大画家	为什么小伙计能成为大画家	1
无声手枪为什么会无声	为什么罂粟被称为有毒植物之王	0
今天天气怎么样	老虎滩的老虎为什么卧在海中	0
怎样更准确地审清题意	为什么蛇的舌头总是伸出来	0
为什么会出现月食	俄罗斯族有什么礼仪及禁忌	0
什么是隐形手枪	什么是反卫星武器	0
为什么海边的白天和黑夜温度变化不大呢	为什么金星表面温度特别高	0
羊多利是怎样被制造出来的	为什么端午节吃粽子	0
为什么幼儿往往用错一些有关时间的语词	为什么有人听不懂古典音乐	0
鹞式战斗机为什么能垂直起降	地磁场变化吗,它变化会有什么影响	0
商品上为什么使用条形码	商品上为什么使用条形码	1
为什么潜艇里的人在水下不会憋死	为什么蚂蚁不上床了	0
为什么毒品是万万不能试的	为什么毒品是万万不能试的	1
为什么用瓶盖做成的小乐器声音很好听	为什么用瓶盖成的小乐器声音很好听	1
为什么装甲车要装空调	为什么岳柱对名画提出批评	0
为什么最热的地方不在赤道	胖人为什么更易饥饿	0
为什么血是红色的	为么血是红色的	1
有头上长角的鱼吗	有头上长角的鱼吗	1
为什么短命菊是植物中生命最短的	为什么说甜橙和橘子不一样	0
脾气和脾有关吗	为什么有人管西瓜叫卡拉哈里沙漠中的球	0
什么是舰载机	什么是舰载	1
卢塞恩玻璃宫为什么叫冰川公园	红糖结块怎么办	0
为什么四大名著能经久不衰	为什么说冬冬是个讲信用的好孩子	0
为什么坦克火炮在颠簸中能打得准	为什么坦克火炮在颠簸能打得准	1
为什么会发生地震	什么是侗族芦笙舞	0
为什么基诺族人喜爱竹子	为什么小草长得特快、特别多	0
为什么英国曾被称为日不落帝国	为什么有的合唱不用伴奏	0
人为什么会得色肓症	为什么战斗机被称作空中霸王	0
为什么称李白为诗仙	为什么植物的根向下生长，茎向上生长	0
为什么超声波能除脏	为什么美国犹他州的天然拱比其他任何地方都多	0
为什么叫含羞泉	什么叫含羞泉	1
雷达是怎样探测目标的	为什么说巨人岬是大自然的杰作	0
CT能检查什么病	为什么说顾恺之是以形写神的画家	0
为什么明明是画却要叫素描	怎样培养你的音乐细胞	0
白族人有哪些礼仪和禁忌	白族人有哪些礼仪和忌	1
为什么停车信号用红色	为什么有的植物间也有冤家对头	0
为什么哈尼族人特别注重礼貌	为什么网络有局域网、城域网和广域网之分	0
为什么金沙江畔会有醉汉林	为什么他能揭开细腰蜂变化的秘密	0
宋词主要分为哪两大流派	宋词主要分为哪两大流	1
萤火虫为什么会一闪一闪的发光	肥胖为什么会合并营养不良	0
为什么萝卜辣，萝卜皮更辣	为什么重阳节要登高	0
为什么黄花菜要晒干以后才能吃	为什么萤火虫会发光	0
为什么黎族要过三月三	为什么黎族要过三月三	1
为什么豆腐和菠菜不能一起煮	为什么豆腐和菠菜不能起煮	1
为什么徐光启要把棉株尖顶上的嫩芽掐断	为什么曹丕命令曹植在七步之内作诗一首	0
为什么伤口愈合时会觉得痒	为什么不能给花浇凉开水	0
为什么迫击炮能击中遮蔽物后的目标	为什么迫击炮能击中遮蔽物后的目标	1
为什么狗认识路	为什么虾片用油一炸就会胀大	0
为什么人能听到自己的回声	为什么人能听到自己的回声	1
换气空调的功能是什么，有什么作用	为什么运动场上的草皮不怕踩	0
为什么王献之的母亲说他练字三千日，只有一点像羲之	为什么耳朵辨不清自己的音色	0
为什么聪明的贝贝不会区分各种几何图形	冥王星为什么是岩石型行星	0
为什么别府温泉首屈一指	为什么有闪电和雷声	0
为什么近视镜的度数应该及时调整	为什么近视镜的度数应及时调整	1
大熊猫人工授精怀孕为什么都是双胞胎	为什么有时太阳周围会出现彩色光圈	0
为什么要使用不同的谱号	为什么要使用不同的谱号	1
彗星会撞上地球吗	彗星会上地球吗	1
为什么在飞机上禁止使用移动电话	什么是黑洞	0
为什么黄花菜要晒干以后才能吃	为什么有的鱼离开水不会死	0
为什么水果不都是甜的	为什么我国是世界上农作物起源最早的国家	0
什么是潜艇	什么是潜艇	1
为什么幼儿学反面角色快	为什么皮肤划破后血会自动凝结	0
铅球出手的角度应该是多少	铅球出手的角度应该是多少	1
为什么丁丁病了还坚持要去幼儿园	圣文森特角为什么有天涯海角之称	0
为什么猴岛成为旅游中的一个热点	怎样去菜馅中的水分	0
怎样合理使用电冰箱	怎样合理使用电冰箱	1
为什么许多动物在水面在墙面上如走平地	新生儿乳房肿大为什么不能挤	0
为什么海边的白天和黑夜温度变化不大呢	为什么太阳月亮会跟着人走	0
为什么切开的茄子放久了表面发黑	为什么物体的重量会变	0
为什么亚当桥不同于一般的桥	为什么亚当桥不同于一般的桥	1
为什么发豆芽要常换水	为什么发豆芽常换水	1
人是怎样发声的	为什么罐装的自动喷剂喷了一会罐身会变凉	0
为什么表演快板书要边说边打竹板	牙齿是怎样分类的	0
什么是鱼雷艇	为什么海龟能认识回故乡的路	0
为什么卫星能观察到地面的情况	为什卫星能观察到地面的情况	1
煤和碳是一回事吗	为什么许多动物在水面在墙面上如走平地	0
为什么壁虎的尾巴容易断	为什么天上会出现新星	0
为什么蚯蚓截成两半还能活	为什么蚯蚓截成两半能活	1
为什么毒蛇和无毒蛇长得不一样	为什么毒蛇和无毒蛇长不一样	1
为什么海带不会开花结籽也能繁殖	为什么刘勰夜晚要到佛殿读书	0
什么是数字电视	为什么鲸不是鱼	0
为什么鱼的身上会有黏液	为什么鱼的身上会有黏液	1
为什么张九龄用鸽子送信	为什么公共汽车开、关门时会发出哧、哧的声音	0
郎世宁对中国传统绘画有何影响	郎世宁对中国传统绘画有何影响	1
为什么说植物是我们的朋友	为什么话剧演员要必修音乐课	0
!·为什么人们喜欢看孔雀舞	!·为什么人们喜看孔雀舞	1
为什么陈咸气坏了父亲陈万年	为什么陈咸气坏了父亲陈万年	1
怎样用树叶制书签	藏族的雪顿节是怎么回事	0
为什么笔是文房四宝中的一宝	为什么有的表要上弦才走，有的表不上弦也走	0
为什么我国古代的书刻在石头上	什么是巡洋舰	0
为什么把唐代上釉的陶器被称做唐三彩	为什么楚辞能够传唱千古	0
为什么说十五分钟是一刻钟	为什么维维含着泪又笑了	0
动物为什么不会迷失方向	为什么萝卜辣，萝卜皮更辣	0
为什么军事上的核时代即将过去	为什么古莲子为我国寿命最长的种子	0
为什么我国北方海岸大多比较平直，南方海岸比较弯曲	为什么我国北方海岸大多比较平直，南方海岸比较弯曲	1
为什么春天会飞出许多白毛毛	为什么巡航导弹离不开数字化地图	0
雷达有哪些战术技术性能	为什么要适当地吃粗粮	0
为什么泰国被称为大象之邦	为什么导弹靠近目标才引爆	0
为什么温度计也有好几种	为什么录像机能自动录像	0
在文章中怎样使用人称	为什么短跑运动员经常拉伤大腿后面的肌肉	0
地球为什么是球形的	为什么夏天星星比冬天多	0
为什么小鸡刚出壳就会走路和吃东西	为什么小鸡刚出壳就会路和吃东西	1
为什么荷花出淤泥而不染	为什么维维含着泪又笑了	0
大海中为什么也有四季变化	大海中为什么也有四季变化	1
为什么纺锤树可以提供自来水	为什么卫星能观察到地面的情况	0
为什么停车信号用红色	为什么停车信号用红色	1
为什么天上会飘雪花	中国画为什么要用毛笔来画	0
火箭和导弹是一回事吗	为什么小飞虫总爱在灯下飞来飞去	0
为什么说雕刻和雕塑不一样	为什么张骞要出使西域	0
你好吗	好吗	1
鄂伦春族过春节与赫哲族有什么不同	为什么孩子要多吃点含钙食品	0
怎样煮蛋不爆	为什么鱼泉会有那么多的鱼	0
为什么子女与父母之间会产生代沟	为什么被蜘蛛吃过的小虫子会剩下空壳	0
怎样使肥皂一物多用	怎样使肥皂一物多用	1
怎样使笔尖好用	什么是余音绕梁，三日不绝	0
为什么天空是蓝色的	为什么黄鳝小时候是雌性，长大了却是雄性	0
熊为什么冬眠？冬眠为什么不脱水	为什么说锡林郭勒大草原是美丽富饶的地方	0
为什么他能揭开细腰蜂变化的秘密	为什么平平眼睛里的水满了	0
为什么说手枪是防身的最好武器	什么说手枪是防身的最好武器	1
为什么岳飞会惨死风波亭	为什么岳飞会惨死风波亭	1
为什么不能单从字面上去理解成语的含义	为什么不能单从字面上去理解成语的含义	1
数字化部队有哪些优势	为什么它是世界上最小的鸟	0
为什么油着火不能用水灭	为么油着火不能用水灭	1
为什么藏族人要在同一天到河里洗澡	中国画为什么有很多画线条的方法	0
为什么潜艇里的人在水下不会憋死	为什么狗睡觉时把嘴藏在前肢下	0
彝族有什么礼仪与禁忌	樱花为什么被称为日本的国花	0
为什么鱼缸里的水草会冒泡	为什么鱼缸里的草会冒泡	1
为什么轰炸机被称做天空杀手	海水为什么是蓝色的	0
为什么篮球队员中没有1、2、3号队员	为什么高压电缆的绝缘子是一节节的	0
为什么有的柑桔没有核	宇宙是什么样子	0
为什么翼龙能在空中飞行	什么是褒义词	0
流星雨怎么形成的	为什么瑞士被称为钟表王国	0
地球为什么也有脉搏	为什么饭前饭后要休息一会儿	0
为什么空气并不空	为什么人有头皮屑	0
为什么黄花菜要晒干以后才能吃	为什么维维含着泪又笑了	0
为什么捕蝇草是最奇特的草	为什么要研究空间脑科学	0
元曲四大家 是谁	无线电波能在水下传播吗	0
为什么指南针有不同的形状，可又总指着南方	为什么指南针有不同的形状，可又总指着南	1
为什么美术又叫造型艺术	为什么美又叫造型艺术	1
为什么藕有许多小洞洞	为什么用x表示未知数	0
为什么王允之要故意装醉	为什么王允之要意装醉	1
为什么月经期不能游泳	为什么月经期不能游泳	1
命题作文为什么要认真审题	为什么说晨晨最勇敢	0
为什么花有大小美丑之分	为什么叫姐妹山	0
近视眼患者为什么要戴眼镜	为什么毕达哥拉斯定理又称为勾股定理	0
为什么齐桓公被称为春秋五霸之首	为什么太阳给我们带来光和热	0
人为什么会变老	人为什么会变老	1
为什么说中国是风筝的故乡	为什么水上飞机能在海上起降	0
为什么常喝鸡汤有助于治疗皮肤病	为什么常喝鸡汤有助于治疗皮肤病	1
山洞为什么被叫做东海龙宫	为什么关电灯后已关的电视屏幕是白的	0
为什么只有老师没有看见	为什么小朋友的胳膊容易脱臼	0
为什么有的柑桔没有核	为什么把大兴安岭称为林海	0
为什么鸟有三个眼睑	为什么端午节吃粽子	0
为什么做眼保健操能预防近视	为什么做眼保健操能预防近视	1
为什么捕蝇草是最奇特的草	为什么捕蝇草是最奇特的草	1
为什么月亮有月相变化	鄂温克族是怎样过米阔鲁节的	0
为什么睡觉时不要蒙着头	为什么和尚念经敲的木鱼也是一种乐器	0
为什么大禹治水的故事至今流传	为什么大禹治水的故事至今流传	1
为什么冬季夜空中的星星比夏季少	为什么糖尿病患者要护脚	0
为什么螺是建筑奇才	为什么能利用卫星进行军事侦察	0
为什么变压器能改变电压的高低	为什么变压器能改变电压的高低	1
彗星为什么有尾巴	彗星为什么有尾巴	1
塔塔尔族和京族的传统节日是什么	为什么闽南的竹子被称为奇竹	0
为什么称我国是种植大豆最早的国家	为什么潜艇里的人在水下不会憋死	0
为什么肠炎、痢疾常在夏秋季发生	为什么肠炎、痢疾常在夏秋季发生	1
怎样更准确地审清题意	为什么说美国是年轻的国家	0
为什么有的植物能连生在一起	为什么有的植物能连生在一起	1
为什么无声手枪是无声的	为什么称老舍为人民艺术家	0
脑袋大的人一定聪明吗	脑大的人一定聪明吗	1
为什么运动场上要穿钉子鞋	为什么说电脑毕竟不能代替人脑	0
为什么海龟和乌龟不一样	为什么合理的膳食应当荤素搭配	0
为什么赫哲族人爱穿鱼皮衣	为什么罂粟被称为有毒植物之王	0
影碟上常见镭射，究竟镭在哪儿，会损害人体吗	甘遂为什么开绿花	0
为什么葡萄会爬架子	怎样使用互联网	0
为什么盐水的沸点高	为什么长白山是我国产人参最多的地方	0
为什么刚掀开的冷冻啤酒瓶口会冒出雾气	为什么经常参加锻炼能使胖人消瘦，能使瘦弱的人变得壮实	0
为什么颐和园内的铜牛是我国最大的铜牛	为什么吃饭时看书不好	0
为什么虾片用油一炸就会胀大	为什么在黑暗中猫能捉到老鼠	0
儿童画为什么不一定是儿童画的	为什么步枪口径越来越小	0
仡佬族是怎样过仡佬年的	为什么响尾蛇的尾巴会发响	0
无声手枪为什么会无声	为什么跑步比赛要逆时针跑	0
为什么中国古代把数学称为算术	为什么葡萄牙人与西班牙人斗牛各不相同	0
为什么有人唱歌声音发抖	为什么白天看不见星星	0
为什么竹子开花就是快死了	为什么竹子开花就是快死了	1
为什么一般人右手的力气比左手大	为什么维维含着泪又笑了	0
为什么张九龄用鸽子送信	为什么演员跳踢踏舞时脚下会发出很响的声音	0
为什么刀钝了，磨磨就能快	为什么红比拉鱼被称为危险动物	0
为什么月球总是以固定的一面对着地球	为什么月球总是以固定的一面对地球	1
为什么被称为盐湖之家	为什么液晶能显像	0
为什么大雁要排成一字或人字形队伍飞行	什么是微声手枪	0
为什么眼睛视力会有变化	人是被电吸住了吗	0
为什么立交桥上会有接缝	为什么蚯蚓截成两半还能活	0
为什么月球总是以固定的一面对着地球	为什么人能听到自己的回声	0
为什么苗族人要过龙船节	为什苗族人要过龙船节	1
为什么司马光要用石头把缸砸破	海水为什么是咸的	0
墙皮为什么会出汗	墙皮什么会出汗	1
水杉是名副其实的世界爷吗	水杉是名副其实的世界爷吗	1
常规潜艇为什么不能长时间在水下	为什么李崇将孩子判给苟泰	0
为什么毛冠鹿的头上没长角	为什么毛冠鹿的头上没角	1
为什么降落伞能使伞兵准确降落	为什么降落伞能使伞兵准确降落	1
什么是机器人	什么是机器人	1
什么是微光电视	什么是微光电视	1
单腿怎么立不住	为什么星星会发光	0
除夕夜为什么家家户户要吃团圆饭	为什么短跑运动员穿上钉子鞋参加比赛时跑得就快	0
为什么美术又叫造型艺术	为什么夏天下雨前天气特别闷热	0
为什么温度计也有好几种	为什么温度计也有好几种	1
如何自制粘蚊蝇纸条	如何自制粘蚊蝇纸条	1
如何给纱窗安拉锁	为什么鸟有三个眼睑	0
为什么精神紧张时手心会出汗	为什么亚当桥不同于一般的桥	0
为什么卫星能观察到地面的情况	为什么卫星能观察到地面的情况	1
为什么竹子开花就是快死了	为什么下雨前小虫特别多	0
唐宋散文八大家指哪些人	为什么说有办法能把海水里的盐去掉	0
动物怎样进行自我医疗	动物怎样进行自我医疗	1
为什么久坐久站脚会发麻	为什么久坐久站脚会发	1
为什么说部首一般都是偏旁，而偏旁不一定是部首	什么是贬义词	0
什么是航天飞机，它在军事上有哪些用途	什么是贫铀弹	0
为什么说地球里面不是厚厚的土	为什么不要空腹喝牛奶	0
为什么幼儿记不住该记的事	驾驶员开车时为什么要系安全带	0
昆虫是怎样保护自己的	为什么说美洲豹比狮、虎的本领都大	0
为什么要限制儿童看电视	为什么电影中会有慢动作镜头	0
什么是机枪	什么是机枪	1
为什么舌头能辨味	为什么说我国的国画是国宝	0
雨是怎样形成的	为什么称中冷泉、惠山泉、观音泉为我国最著名的泉	0
中国画为什么要用毛笔来画	为什么不能拿大伙儿的东西	0
为什么彩虹的七色顺序总是不变	为什么虹的七色顺序总是不变	1
为什么曹刿能够战胜强大的齐军	为什么有的树能自己长出来	0
节食为什么不减肥反而增肥	节食为什么不减肥反而增肥	1
为什么花盆底部有个小洞	水开后摸壶底,烫手吗	0
为什么北京有那么多有名和好玩的地方	你知道声乐演唱有哪些形式吗	0
为什么海豹不睡大觉	为什么海豹不睡大觉	1
为什么蜗牛爬行时会留下足迹	什么是鱼雷艇	0
为什么炮弹的发射药中要用除铜剂	为什么合唱受到很多人喜爱	0
人为什么会出汗	大炮能把卫星送上天吗	0
为什么说要用心去观察	为什么说要用心去观	1
为什么张大千被誉为当代第一大画家	为什么张大千被誉为当代第一大画家	1
为什么先看到闪电后听到雷声	狂犬病是怎么回事	0
为什么通用机枪多为轻重两用	为什么感冒后会流涕、鼻塞和发热	0
吃带鱼要去鳞吗	吃带鱼要鳞吗	1
为什么唱歌喉音重不好听	为什么潜艇在水下能认路	0
为什么月亮不会发光却是明亮的	为什么月亮不会发光却是明亮的	1
世界火炉指的是哪里	为什么说要用心去观察	0
为什么要使用信用卡	为什么暴饮暴食有时可以致命	0
什么是贫铀弹	歌曲二字的含义是什么	0
爬云梯的梯子短一些是否更安全	爬云梯的梯子短一些是否更安全	1
为什么鸡蛋不能吃太多	猪为什么用嘴巴拱泥土	0
为什么叫马跑泉	为什么叫跑泉	1
为什么鱼有鳞片	为什么说不老松是我国最古老的一棵松树	0
自行车倒千斤怎么办	自车倒千斤怎么办	1
为什么叫太阳海岸	为么叫太阳海岸	1
什么是贫铀弹	么是贫铀弹	1
为什么螃蟹要吐沫	为什么螃蟹要吐沫	1
为什么从冷气间走出来，眼镜会模糊一片	为什么藕有许多小洞洞	0
为什么火箭要垂直发射	什么火箭要垂直发射	1
植物的种子和果实会爬行吗	植物的种和果实会爬行吗	1
维吾尔族有什么礼仪、禁忌	驾驶员开车时为什么要系安全带	0
为什么投降举白旗	为什么人一哭就会流鼻涕	0
给电池充电先要放掉剩余的电，对吗	给电池电先要放掉剩余的电，对吗	1
为什么流星会从天上掉下来	天为什么是蓝色的	0
为什么曹冲能知道大象的重量	为什么秦始皇要焚书坑儒	0
为什么他能揭开细腰蜂变化的秘密	为什么他能揭开细腰蜂变化的秘密	1
常吃钙片为什么也会缺钙	为什么说他是聪明的小皇帝	0
为什么蛇能在黑夜里捕捉到田鼠	为什么红色印泥不易褪色	0
什么是巡洋舰	尿是怎么形成的	0
为什么毕达哥拉斯定理又称为勾股定理	为什么毕达哥拉斯定理又称勾股定理	1
冬季为什么用湿手接触铁器时会被粘住	冬季为什么用湿手接触铁器时会被粘住	1
宋词主要分为哪两大流派	宋词主要分为哪两流派	1
为什么游泳时尿多	为什么小飞虫总爱在灯下飞来飞去	0
天为什么是蓝色的	换气空调的功能是什么，有什么作用	0
脑袋大的人一定聪明吗	为什么蚂蚁要爬到喜鹊的身上	0
为什么称作一勺之多泉	为什么称作一勺之多泉	1
为什么自己挠胳肢窝不会痒	为什么自己挠胳肢窝不会痒	1
为什么说大脑是人体的指挥中心	你知道高山流水的故事吗	0
楔式炮闩体为什么做成棱柱形	楔式炮闩体为什么做成柱形	1
郎世宁对中国传统绘画有何影响	郎世宁对中国传统绘画有何影响	1
为什么鸸鹋又叫长跑健将	为什么鸸鹋又叫长跑健将	1
为什么肠炎、痢疾常在夏秋季发生	为什么肠炎、痢疾常在夏秋季发生	1
为什么青少年不宜经常开夜车	为什么苹果皮上会有黑褐色干皮	0
为什么伤口愈合时会觉得痒	为什么伤口愈合时会觉得痒	1
元曲四大家 是谁	元曲四大家 是谁	1
汽油的90#、93#、97#是什么意思	为什么有人唱歌声音发抖	0
鲁迅为什么要塑造阿Q这个人的形象	为什么要研究空间脑科学	0
为什么叫蜡染布	为什么蜡染布	1
为什么小熊猫总长不大	金粉和银粉是用金子和银子做的吗	0
为什么狮子大王收到的是一袋水	什么是绿色冰箱	0
为什么小儿易出现肠套叠	为什么长跑时呼吸节奏很重要	0
无线电波能在水下传播吗	为什么皮肤晒黑是正常现象	0
为什么幼儿对童话故事和童话剧特别感兴趣	你知道声乐演唱有哪些形式吗	0
为什么不让踩草坪	为什么不让踩草坪	1
为什么郑成功能收复台湾	为什么叫蜡染布	0
为什么在陶瓷上可以烧出各种美丽的颜色	为什么在陶瓷上可以烧各种美丽的颜色	1
为什么诸葛恪往牌子上加上之驴两个字	你知道高山流水的故事吗	0
为什么花也要睡觉	彗星为什么有尾巴	0
为什么螃蟹要吐沫	为什么螃蟹吐沫	1
铁锤为什么砸不坏肚子	为什么贝类身上要长壳	0
鱼雷是怎样击中目标的	为什么太阳照的地方，小朋友会感到暖和	0
火星上有生命吗	手枪托弹簧为什么不能装反装倒	0
为什么一般人右手的力气比左手大	为什么珊珊喜欢用粒粒橙汁罐做小娃娃	0
什么是布雷舰	塔塔尔族和京族的传统节日是什么	0
什么是全球定位系统	为什么说部首一般都是偏旁，而偏旁不一定是部首	0
为什么鸟的歌声特别婉转动听	为什么鸟的歌声特别婉转动听	1
为什么人有头皮屑	为什么人头皮屑	1
什么是冲锋枪	什么是锋枪	1
为什么哈尼族人特别注重礼貌	为什么下棋的人让王粲重新摆一遍棋子	0
为什么孩子喝水要选择时间	为什么建筑物会是多种多样的	0
彝族有什么礼仪与禁忌	为什么电风扇能使人感到凉快	0
为什么补色法能显示景物的立体感	为什么有的小朋友容易患驼背	0
为什么称女神峰等景观是三清山三绝	额不里海滩为什么是旅游的好地方	0
为什么人吸进氧气，呼出时变成了二氧化碳	冰川是如何形成的	0
眼镜腿转动不灵怎么办	为什么凹镜中看到的图像是倒置的	0
为什么奥运会以五色环为标志	为什么奥运会以五色环为标志	1
为什么月球总是以固定的一面对着地球	为什么金沙江畔会有醉汉林	0
为什么会出现开元盛世	为什么鸽子会成双成对	0
什么是反卫星武器	为什么极光出现在地球两极	0
为什么电子琴能模拟其他乐器的声音	什么是景泰蓝艺术	0
为什么有的幼儿在陌生人和集体面前表现得很胆怵	为什么有的幼儿在陌生人和集体面前表现得很胆怵	1
为什么云南大理最大的集市叫三月街	为什么宋太祖要杯酒释兵权	0
为什么拨号上网要用猫	为什么云南大理最大的集市叫三月街	0
为什么红灯停，绿灯行	什么是鱼雷艇	0
为什么菠菜和豆腐不要一起煮	为什么菠菜和豆腐不要一起煮	1
同样的粘沙土为什么能烧成不同的砖	为什么吃饭时说话会呛着	0
为什么碳钟可以测定古文物的年龄	为什么碳钟可以测定古文物的年龄	1
为什么看不见鸟洗澡，鸟也很干净	新买来的胶卷为什么外面都包着黑纸	0
为什么有人唱歌声音发抖	磁通量不改变也会产生感应电流吗	0
为什么豆腐和菠菜不能一起煮	为什么闽南的竹子被称为奇竹	0
为什么植物也有寄生虫	什么是发射窗口和发射场	0
为什么要研究空间脑科学	为什么要研究空间脑科学	1
为什么最热的地方不在赤道	为什么最热的地方不赤道	1
为什么贝类身上要长壳	为什么儿童团长王璞能抓住特务	0
果树为什么有大小年	果树为什么有大小年	1
驾驶员开车时为什么要系安全带	为什么广州也叫羊城	0
为什么要重视孩子的眼外伤	为什么新疆被称为瓜果之乡	0
号称绿色陷阱的沼泽是怎样形成的	为什么要保护壁虎	0
什么是巡洋舰	为什么猴岛成为旅游中的一个热点	0
为什么怪石被称为大象石	为什么怪石被称为大象石	1
怎样煮蛋不爆	为什么不要轻易切除孩子的扁桃体	0
近视眼患者为什么要戴眼镜	为什么做脑电图不会损伤大脑	0
世界上有多少种昆虫	为什么日食发生在初一而不是十五	0
给电池充电先要放掉剩余的电，对吗	为什么电冰箱有时嗡嗡响	0
男孩子为什么爱意气用事	为什么航空母舰能载飞机	0
为什么玻璃杯里的纸不湿	植物怎样对付昆虫的蚕食	0
什么是武器的战斗性能	什么是武器的战斗性能	1
为什么不要蒙头睡觉	为什么有的人分辨不出颜色	0
春天的萝卜为什么会糠	少数民族是怎样巧用箭毒树的	0
为什么地雷壳要采用塑料制成	为什么雷壳要采用塑料制成	1
为什么人有头皮屑	什么人有头皮屑	1
为什么光可窃听	为什么熟鸡蛋能竖立旋转	0
为什么植物喜欢找气味相投的朋友	为什么植物喜欢找气味相投的朋友	1
为什么马德堡半球实验能证明压强的存在	为什么马德堡半球实验能证明压强的存在	1
老年人怎样自我检查	老人怎样自我检查	1
为什么熊猫的爪是六指儿	为什么熊猫的爪六指儿	1
为什么幼儿常常爱告状	什么幼儿常常爱告状	1
为什么说大脑是人体的指挥中心	圣马可广场为什么那么吸引人	0
日月平升是怎么回事	积累词汇有哪些途径	0
什么是方言词	为什么树木能把人吃掉	0
为什么蜗牛爬行时会留下足迹	为什蜗牛爬行时会留下足迹	1
为什么成熟的水果会变色	为什么把大兴安岭称为林海	0
天为什么是蓝色的	天为什么是蓝色的	1
为什么说四川是天府之国	为什么马要站着睡觉	0
为什么登山被称为勇敢者的运动	我国的黄土高原上为什么常年覆盖着黄土	0
为什么有些男孩子也爱害羞	为什么说徐文长是个聪明的孩子	0
为什么比赛前要检测兴奋剂	为什么比赛前要检测兴奋剂	1
为什么银杏树有活化石之称	圣克劳德为什么叫做烟斗之城	0
肥皂泡的大小如何变	套马是哪个民族的传统体育项目	0
为什么羌族人的房顶上立着块石英石	为什么藏族人要在同一天到河里洗澡	0
怀孕后为什么要少吃米饭	为什么鹅兵会作战	0
为什么说人类离不开植物的光合作用	为什么把有的乐队叫交响乐队	0
为什么去畲族人家进门有三道关	迫击炮弹为什么没有弹带而有尾翼	0
为什么叫摇篮曲	为什么叫摇篮曲	1
果实成熟后为什么会掉下来	果实熟后为什么会掉下来	1
什么是绿色冰箱	什么是绿色冰箱	1
为什么磕头虫会磕头	为什么有的花香，有的花臭	0
为什么要用互联网	卡普里岛为什么又叫野猪岛	0
镜子背面镀的是什么	镜子背面镀的是什	1
为什么禁放烟花爆竹	运动后肌肉酸痛怎么办	0
什么是高射机枪	为什么比赛前要检测兴奋剂	0
为什么中国画家喜欢在画上题字	为什么中国画家喜欢在画上题字	1
现代银行为什么开始广泛应用计算机	现代银行为什么开始广泛应用计算机	1
为什么说白血球是人体卫士	!·为什么几片云彩会把整个太阳遮住	0
为什么北京的古建筑多用九	为什么饮绿茶能消除口臭	0
为什么说黑枣不是枣	为什么说黑枣不是枣	1
你好吗	为什么空气并不空	0
雷达是怎样探测目标的	柏树为什么是梨树的坏邻居	0
为什么韩德常老师是幼儿音乐教育家!·和幼儿作曲家	谢安为什么要批评哥哥	0
阿尔瓦德岛为什么叫美人岛	阿尔瓦德岛什么叫美人岛	1
有些坦克炮的抽烟装置为什么偏置	有些坦克炮的抽烟装置为什么偏置	1
你会打秋千吗	你会打千吗	1
为什么不能吃死鳝鱼	为什么不能吃死鳝鱼	1
为什么电冰箱在停机后不能立刻起动	为什电冰箱在停机后不能立刻起动	1
为什么菠菜和豆腐不要一起煮	为什么菠菜和腐不要一起煮	1
什么是微光夜视仪	什么是微光夜视仪	1
为什么幼儿特别愿意和玩具小动物说话	为什么米芾的字写得那样好	0
为什么燃烧的蜡烛有时会冒黑烟	鱼真的不睡觉吗	0
为什么曹冲能知道大象的重量	为什么曹冲能知道大象的重量	1
为什么车胤要囊萤读书	少女为什么会来月经	0
风是怎样形成的	为什么说齐白石是我国近代艺术大师	0
为什么不宜长久呆在空调房间里	为什么能听到对牧师做的忏悔	0
为什么叶子两面的颜色深浅不同	为什么叶子两面的颜色深浅不同	1
为什么听自己录音会觉得声音变了	为什么听自己录音会觉得声音变了	1
扬州八怪怪在何处	扬州八怪怪在何处	1
露是怎样形成的	露是怎样形成	1
为什么喝粥能滋补身体	为什么喝粥能补身体	1
高科技炮弹有哪些	什么是冲锋枪	0
为什么傣族人喜欢住竹楼	谢安为什么要批评哥哥	0
为什么韩愈买来一根蜡烛	为什么韩愈买来一根蜡	1
为什么说喜鹊是田野卫士	为什么喜鹊是田野卫士	1
为什么要在花盆里放些空蛋壳	什么要在花盆里放些空蛋壳	1
为什么小朋友的心脏跳动比成人快	为什么小朋友的心脏跳动比成人快	1
为什么独龙族人都吃大锅饭	为什么独龙族人都吃大锅饭	1
为什么有的墙用空心砖来砌	为什么有的墙用空心砖来砌	1
为什么流星会从天上掉下来	为什么毛泽东把饭让给小朋友吃	0
为什么飞鱼会飞	为什么飞鱼会飞	1
人造卫星为什么会飞出地球	油画为什么要用油来调颜色	0
为什么说大脑是人体的指挥中心	为什么珊珊小朋友午睡时不上床	0
为什么白酒有各种不同的酒香	为什么白酒有各种不同的酒香	1
为什么狮子大王收到的是一袋水	冷水和热水哪个沸腾快	0
为什么豆类食品有益健康	什么豆类食品有益健康	1
为什么鼻子贴在花上闻花香不好	为什么鼻子贴花上闻花香不好	1
为什么会藕断丝连	为什么要适当地吃粗粮	0
为什么说黑枣不是枣	为什么水上飞机能在海上起降	0
为什么泰国被称为大象之邦	为什么泰国被称为大象之邦	1
反装备武器有哪些	为什么鸟飞行时要把两腿藏在身下	0
为什么鸽子会成双成对	为什么战国时期会形成百家争鸣的局面	0
为什么云有各种不同的颜色	如何自制粘蚊蝇纸条	0
为什么人吸进氧气，呼出时变成了二氧化碳	为什么人吸氧气，呼出时变成了二氧化碳	1
乐山大佛是怎样建成的	为什么红细胞有免疫功能	0
为什么相声要引人发笑	为什么极光出现在地球两极	0
为什么山洞取名为落笔洞	为什么山洞取名为落笔洞	1
为什么傣族人喜欢住竹楼	为什么海带不会开花结籽也能繁殖	0
为什么把有的乐队叫交响乐队	为什么激光武器有很强的杀伤力	0
为什么沙锤演奏时发出沙沙的声音	为什么宰相管李泌叫小友	0
如何确定太阳系在银河系中的位置	如何确定太阳系在银河系中的位置	1
为什么肖思话决心改恶从善	怎样合理使用电冰箱	0
珊瑚为什么这样美	塔吉克族是怎样过迄脱迄迪尔节的	0
你知道十二部对歌是哪个民族的情歌吗	为什么大蒜能杀菌	0
为什么新疆被称为瓜果之乡	为什么新疆被称为瓜果之乡	1
为什么寄居蟹和海葵是好朋友	五谷是哪五种农作物	0
为什么明明是画却要叫素描	什么是潜艇	0
为什么李贺让母亲担忧	为什么独龙族人都吃大锅饭	0
针灸为什么能治病	海洋为什么会变成红色	0
为什么说音乐能寓教于乐	为什么只有同种植物的花粉才能受精	0
为什么海水是咸的	为什么壁虎能在墙上爬却不掉下来	0
为什么幼儿往往用错一些有关时间的语词	人为什么感觉到冷	0
为什么新疆是我国最大的瓜果生产基地	为什么新疆是我国最大的瓜果生产基地	1
为什么在陶瓷上可以烧出各种美丽的颜色	为什么叫做莫干山	0
山谷的风是怎样形成的	什么是反义词	0
为什么称女神峰等景观是三清山三绝	为什么范正平要走着上学，却不肯骑马、坐轿	0
为什么飞机要装红绿灯	为什么飞机要红绿灯	1
熊为什么冬眠？冬眠为什么不脱水	电风扇能降低室温吗	0
为什么已排除的化学地雷应运到安全地点处理	为什么已排除的化地雷应运到安全地点处理	1
为什么多给植物喝水，它反而会死亡	为什么管这种熊又叫浣熊	0
为什么仡佬族人要给牛过生日	为什么虫子飞的时候会嗡嗡地叫	0
蚂蚁为什么认识寻找食物的路径	为什么鳄鱼不属于鱼	0
为什么久坐久站脚会发麻	为什么久坐久站脚会发麻	1
为什么鱼在冰冷的水里不怕冷	湖泊是怎样形成的	0
跳台滑雪运动起源于哪儿	为什么说我国的地形分布是有规律的	0
春天的萝卜为什么会糠	为什么楼房外边的墙上要安装管子	0
分子发动机很小有多小	分子发动机小有多小	1
为什么他俩不去评理了	核潜艇和普通潜艇的区别是什么	0
什么是对牛弹琴和对马弹琴	为什么传真机可以传递信息	0
为什么说黑枣不是枣	为什么牙齿有不同的形状	0
为什么瑶族人庆祝达努节	为什么瑶族人庆祝达努节	1
为什么说墨不一定是黑的	为什么独龙族人都吃大锅饭	0
什么是侗族芦笙舞	为什么从冷气间走出来，眼镜会模糊一片	0
为什么纸盒做的小火车能拐弯	为什么纸盒做小火车能拐弯	1
为什么网络可以入侵	为什么网络可以入侵	1
为什么领港鱼不怕大鲨鱼	收音机为什么会有杂音	0
为什么篮球队员中没有1、2、3号队员	为什么英国曾被称为日不落帝国	0
为什么南海的小岛数也数不清	猜猜他在干什么	0
为什么会出现日食和月食现象	中国画为什么有很多画线条的方法	0
为什么月亮不会发光却是明亮的	为什么吴道子的作品被称作吴带当风	0
为什么说她是聪明的小姑娘	为什么娜娜会把幼儿园的积木拿回家	0
为什么玻璃杯里的纸不湿	为什么玻璃杯的纸不湿	1
什么是生物战剂	么是生物战剂	1
为什么李贺让母亲担忧	春天的萝卜为什么会糠	0
为什么每个人的指纹不一样	为什么激光有各种颜色	0
海浪为什么迎岸而来	为什么海豹喜欢吃石块	0
为什么制导炮弹能精确打击目标	为什么要保护壁虎	0
为什么明明是画却要叫素描	为什么生活在贝壳里的动物叫软体动物	0
不同的树过冬方法相同吗	不同的树过冬方法相同吗	1
为什么植物有酸、甜、苦、辣的味道	为什么植物有酸、甜、苦、辣的味	1
为什么黎族要过三月三	为什么碰伤的皮肤处会有乌青块	0
为什么有的海洋会发光	为什么有的海洋会发光	1
为什么云有不同的颜色	为什么丹麦被称为童话王国	0
为什么文彦博要往树洞里灌水	为什么鲸类有流眼泪的习性	0
为什么白天看不见星星	为什么吕后会乱政	0
什么是数字电视	什么是数字电视	1
为什么在夏天自行车胎容易放炮	为什么恒星会发光	0
动物怎样进行自我医疗	为什么治疗肠虫病要用安乐士	0
为什么韭菜割了以后还能再生长	!·为什么几片云彩会把整个太阳遮住	0
命题作文为什么要认真审题	为什么会发生八王之乱	0
为什么人体的左右不对称	为什么孝文帝要改制	0
月全食的时候为什么月亮是暗红色	月全食的时候为什么月亮是暗红色	1
为什么把乒乓球称为桌上的网球	为什么蜜蜂蜇人后自己也会死掉	0
为什么大、小兴安岭及完达山是我国最大的森林基地	唐宋八大家是哪几位	0
为什么中国画家喜欢在画上题字	为什么中国画家喜欢在画上题字	1
为什么小海马不是海马爸爸生的	为什么电冰箱有时嗡嗡响	0
胫骨前痛是怎样引起的	胫骨前痛是怎样引起的	1
为什么不能用生豆油拌馅	为什么叶子两面的颜色深浅不同	0
为什么吃饭前后不要做剧烈活动	为什么吃饭后不要做剧烈活动	1
为什么应该培养随手查字典的习惯	什么应该培养随手查字典的习惯	1
什么是贫铀弹	昆虫怎样吃东西	0
铅字是光用铅制造的吗	铅字是光用铅制造的吗	1
冬天运动时出汗要注意什么	为什么天空是蓝色的	0
为什么听自己录音会觉得声音变了	无声手枪为什么会无声	0
为什么咖啡能提神醒脑	为什么晴天时显得天高，阴天时显得天矮	0
为什么要多吃鱼	为什么要吃鱼	1
为什么马要站着睡觉	号称绿色陷阱的沼泽是怎样形成的	0
昆虫怎样吃东西	昆虫怎样吃东西	1
水族为什么要过端节	为什么螃蟹要吐沫	0
为什么天空中的云总是变化，空中的云是从哪儿来的	为什么天空中的云总是变化，空中的云是从哪儿的	1
天为什么是蓝色的	为什么郭翻受到大家的敬重	0
为什么白天能看见太阳，晚上看不见太阳	为什么老奶奶要磨铁棒槌	0
中国人为什么特别钟爱丹顶鹤	中国人为什特别钟爱丹顶鹤	1
为什么传说天上有条银河	为什么传说天上有条银河	1
你好吗	你好吗	1
为什么中国人自称为炎黄子孙	雷声为什么隆隆作响很长时间	0
为什么鸟类有偷东西的嗜好	为什么传真机可以传递信息	0
海水为什么是咸的	海水为什么是咸的	1
为什么小佳佳会盛气凌人	为什么情绪变化会影响身心健康	0
爆炸时寂静区是怎样形成的	为什么房顶上能长出小树小草	0
癌细胞为什么会转移	癌细胞为什么会转	1
为什么打野战要穿迷彩服	为什么刚掀开的冷冻啤酒瓶口会冒出雾气	0
画中国画的纸为什么同画其他画的纸不一样	为什么幼儿常常爱告状	0
为什么隐形飞机会隐身术	什么隐形飞机会隐身术	1
为什么鱼有淡水鱼、海水鱼之分	为什么会出现姑娘身上的酒店	0
火车头能做得轻便些吗	为什么买不到活的海水鱼	0
为什么鸟的歌声特别婉转动听	为什么鱼缸里的水草会冒泡	0
为什么称聊斋志异是中国古典文学短篇小说的代表作	大海中为什么也有四季变化	0
为什么叫神光山	为什么叫神光	1
为什么说宇宙有限而无边	为什么说宇宙有限无边	1
为什么没煮熟的豆浆不能喝	为什么没煮熟的浆不能喝	1
为什么要用三脚插头	为什么空气并不空	0
静电复印机是怎样工作的	为什么受伤的水果会变黑	0
为什么小明选择了雪	为什么说她是聪明的小姑娘	0
为什么毛泽东把饭让给小朋友吃	给电池充电要先放掉剩余的电，对吗	0
为什么中医也讲阴阳五行	为什么人吸进氧气，呼出时变成了二氧化碳	0
为什么体操运动员要在手上涂白色粉末	为什么体操运动员要在手上涂白粉末	1
为什么不宜长久呆在空调房间里	同样的粘沙土为什么能烧成不同的砖	0
为什么献血不会影响身体健康	为什么做脑电图不会损伤大脑	0
为什么早餐很重要	为什么把从我国到古罗马国的路称作丝绸之路	0
为什么南极的冰比北极多	为什么把花的叶子摘了，花就死了	0
地球同步轨道就是地球静止轨道吗	为什么人着凉就可能得病	0
家用电表分表与总表为什么又误差	为什么藏族人民家家都养牦牛	0
为什么说美术不光是指绘画	为什么别府温泉首屈一指	0
为什么佤族人都随身带着筒帕	为什么预警机要背个大圆盘	0
密度计的刻度为什么是不均匀的	为什么他们争着让水桶离自己近一点	0
为什么头发会脱落	为什么头会脱落	1
月亮为什么沿着奇怪的轨道绕地球转	月亮为什么沿着奇怪的轨道绕地球转	1
运动后肌肉酸痛怎么办	运动后肌肉酸痛怎么办	1
为什么李世民会发动玄武门之变	为什么李世民会发动玄武门之变	1
什么是超声显微镜	什么是超显微镜	1
长颈鹿的脖子为什么那么长	长颈鹿的脖子为什么那么长	1
什么是反坦克导弹	什么是反坦克导弹	1
为什么秦皇岛不是岛	为什么秦皇岛不是岛	1
为什么青春期要多吃碘	为什么说甜橙和橘子不一样	0
为什么洗衣机能洗干净衣服	为什么洗衣机能洗干净衣服	1
为什么电冰箱有时嗡嗡响	世界火炉指的是哪里	0
为什么大雁要排成一字或人字形队伍飞行	为什么大雁要排成一字或人字形队伍飞行	1
为什么岳飞会惨死风波亭	为什么运动场上要穿钉子鞋	0
为什么说埃及是尼罗河的赠礼	什么是戏曲的唱念做打	0
胃切除后为什么还能消化食物	为什么马的耳朵时常摇动	0
为什么毛泽东把饭让给小朋友吃	为什么毛泽东把让给小朋友吃	1
花灯是流行于哪些民族中的民间歌舞	花灯是流行于哪些民族中的民间歌舞	1
为什么地球又叫蓝色的星球	为什么把家春秋称为现代红楼梦	0
为什么天空是蓝色的	为什么天空是蓝的	1
为什么月球车能在月球上行驶	为什么冬天暖房要开窗子	0
有些坦克炮的抽烟装置为什么偏置	为什么淝水之战中东晋军能以少胜多	0
为什么大多数人右手的力气比左手大	为什么大多数人右手的力气比左手大	1
为什么听自己录音会觉得声音变了	为什么听自己录音觉得声音变了	1
什么是太阳风	为什么线轴木偶像个捉迷藏的小淘气	0
为什么天上的星星有时多，有时少	海南沉香是什么	0
水滴落沸油中会怎样	水滴落沸油中会怎	1
为什么数星星的孩子能成为天文学家	为什么数星星的孩子能成为天文学家	1
为什么说过分限制孩子的活动对其身心发展不利	为什么伤口愈合时会觉得痒	0
为什么小苏打能代替碱面	为什么盆栽花要换盆	0
为什么运动前要做准备活动	地球为什么会自转	0
为什么有时候蜻蜓飞得很低	为什么有时候蜓飞得很低	1
为什么有时枪会胀膛炸膛	为什么兄弟们不再争吵了	0
为什么在飞机上禁止使用移动电话	为什么在飞机上禁止使用移动电话	1
为什么吃水果也要适量	为什么火车到站后，工人要用锤子在车下敲打	0
为什么水仙花喝清水就能生长开花	为什么早餐很重要	0
为什么太阳能晒干衣服却晒不干花草	为什么柿子有的甜、有的涩	0
为什么珊珊喜欢用粒粒橙汁罐做小娃娃	为什么珊珊喜欢用粒粒橙汁罐做娃娃	1
植物怎样对付昆虫的蚕食	植物怎样对付昆虫的蚕食	1
为什么白酒有各种不同的酒香	什么白酒有各种不同的酒香	1
什么是反卫星武器	为什么巨杉是 世界巨木之首	0
为什么把家春秋称为现代红楼梦	为什么下雪时不冷，雪融时很冷	0
为什么颐和园里的铜牛没有尾巴	为什么会出现贞观之治	0
你知道傈僳族有哪些礼仪和禁忌吗	你知道傈僳族有哪些礼仪和禁忌吗	1
为什么宰相管李泌叫小友	为什宰相管李泌叫小友	1
为什么人会有冷和热的感觉	为什么人会有冷和热的感觉	1
什么是磁悬浮列车	什是磁悬浮列车	1
为什么有些男孩子也爱害羞	!·壮族有些什么礼仪与禁忌	0
星系会互相吞并吗	北京时间取自哪里	0
为什么山洞取名为落笔洞	为什么要重视孩子的眼外伤	0
为什么不要空腹喝牛奶	为什么火星看上去是红色的	0
为什么海豹喜欢吃石块	为什么地球上有那么多山	0
为什么有的人鼻子容易出血	注射青霉素前为什么要做皮试	0
为什么孟母三次搬家	为什么人们不能直接吃河豚	0
为什么不要空腹喝牛奶	为什么摄像机摄像时不需要对焦和曝光	0
为什么花癫患者都是青少年	为什么鳄鱼不属于鱼	0
为什么世界上第一把小提琴是埃及的音乐家莫可里制造的	为什么世界上第一把小提琴是埃及的音乐家莫可里制造的	1
为什么幼儿经常自言自语	恒星的一生是怎样的	0
为什么冬季夜空中的星星比夏季少	为什么在飞机上禁止使用移动电话	0
人为什么会出汗	为什么下雪天时，地沟盖上却没有雪	0
为什么铅球的重量是7.257千克	你知道黎族有哪些礼仪和禁忌	0
为什么蚂蟥具有医学用途	为什么蟥具有医学用途	1
为什么匡衡要凿壁借光	霜是怎样形成的	0
镜子背面镀的是什么	镜子背面镀的是什么	1
元曲四大家 是谁	元曲四大家 是	1
郎世宁对中国传统绘画有何影响	郎世宁对中国传统绘画何影响	1
为什么用湿布抹冰箱的冰格会被粘着	你知道人声有哪些类别吗	0
为什么昆虫会蜕皮	为什么录像机能自动录像	0
哈尼族有什么礼仪及禁忌	为什么计算机也会生病	0
为什么周处要痛改前非	为什么马德堡半球实验能证明压强的存在	0
怎样去菜馅中的水分	怎样菜馅中的水分	1
卫星是怎样发射的	为什么蟋蟀会用翅膀唱歌	0
什么是单音词、复音词	为什么不能对小学生的作文求全责备	0
摩托车的二冲程和四冲程车有什么不同	摩托车的二冲程和四冲程车有什么不同	1
为什么高速飞行需设置特殊的跳伞装置	为什么跳芭蕾舞要立起脚尖	0
为什么太阳照的地方，小朋友会感到暖和	为什么颜料有透明不透明的区别	0
为什么说要用心去观察	为什说要用心去观察	1
海洋为什么会变成红色	海洋为什么会变成红色	1
为什么有的人会花粉过敏	为什么有的人会花粉过敏	1
为什么合唱受到很多人喜爱	纳西族有哪些礼仪和禁忌	0
鹞式战斗机为什么能垂直起降	世界四大水果是哪几种	0
为什么油着火不能用水灭	为什么话剧演员要必修音乐课	0
为什么跳水有空中芭蕾之称	为什么跳水有空中芭蕾之称	1
为什么磁卡电话能自动计费	为什么磁卡电话能自动计费	1
彗星会撞上地球吗	彗星会撞上地球吗	1
为什么荷兰被称为风车之国	什么是气垫船	0
为什么有的鱼离开水不会死	为什么有的鱼离水不会死	1
为什么贝类身上要长壳	为什么数码相机不使用胶卷	0
大熊猫人工授精怀孕为什么都是双胞胎	大熊猫人工授精怀孕为什么都是双胞胎	1
铅球出手的角度应该是多少	彗星为什么有尾巴	0
为什么兔子的耳朵很长	为什么兔子的耳朵长	1
为什么水能灭火	为么水能灭火	1
为什么不让皇帝看起居注	为什么不让皇帝看起居注	1
恒星的一生是怎样的	为什么蚂蟥具有医学用途	0
为什么太阳给我们带来光和热	水杉是名副其实的世界爷吗	0
为什么吉他是人们最喜爱的乐器之一	恒星的一生是怎样的	0
汽油的90#、93#、97#是什么意思	为什么用瓶盖做成的小乐器声音很好听	0
什么是激光雷达	什么激光雷达	1
为什么小熊猫总长不大	为什么小熊猫总长不大	1
为什么中国画家喜欢在画上题字	为什么最早的火箭是中国发明的	0
为什么宋太祖要杯酒释兵权	为什么宋太祖要杯酒释兵权	1
为什么会产生龙卷风	为什么儿童团长王璞能抓住特务	0
为什么喷气式飞机烧煤油而不烧汽油	用了为什么的句子，后面一定要加问号吗	0
为什么要照顾年龄小的伙伴儿	为什么要照顾年龄小的伙伴儿	1
为什么幼儿学反面角色快	为什么幼儿学反面角色	1
为什么蛇的舌头总是伸出来	为什么蛇的舌头总是伸出来	1
为什么冰梅石是常州奇观	为什么许衡不肯摘梨解渴	0
为什么孟母三次搬家	为什么喷气式飞机烧煤油而不烧汽油	0
为什么计算机又称电脑	为什么计机又称电脑	1
为什么有些验血项目需要空腹进行	为什么有些验血项目需要腹进行	1
为什么说画人难画手	为什么景颇族人每年要举行木脑盛会	0
为什么要提倡背诵一些精美的文学作品	旋转球为什么不走直线	0
针灸为什么能治病	为什么没煮熟的豆浆不能喝	0
石油是怎样形成的	为什么人一冷皮肤上就会起鸡皮疙瘩	0
樱花为什么被称为日本的国花	为什么太阳给我们带来光和热	0
为什么茶树都生长在南方	为么茶树都生长在南方	1
柏树为什么是梨树的坏邻居	柏树为什么是梨树的坏邻居	1
为什么患肾炎的人仍能参加体育活动	为什么叶子两面的颜色深浅不同	0
为什么少年长白发	为什么少年长发	1
爬云梯的梯子短一些是否更安全	为什么说埃及金字塔是古代文明史上的奇迹	0
为什么秦始皇被称为千古第一帝	为什么萌萌拆半导体	0
为什么白天能看见太阳，晚上看不见太阳	为什么自行车比赛选手要走之字形路线	0
为什么蝴蝶可以做到没有声音得飞舞	为什么有的人会花粉过敏	0
为什么要给星星取名字	为什么要给星星取字	1
为什么熟鸡蛋能竖立旋转	黄山的怪石上为什么长奇松	0
为什么肥皂能清洗手部的脏污	为什么司马光要用石头把缸砸破	0
乙醇汽油和普通汽油有什么不同	为什么戴碧荣会失去左臂和左腿	0
被疯狗咬伤怎么办	被疯狗咬伤怎么办	1
节食为什么不减肥反而增肥	为什么话剧演员要必修音乐课	0
近视眼患者为什么要戴眼镜	为什么内蒙古举行那达慕大会时那么热闹	0
音乐为什么是人生活中的亲密伴侣	音乐为什么是人生活中的亲伴侣	1
为什么海王星的环呈短弧状	为什么海王星的环呈短弧状	1
核潜艇和普通潜艇的区别是什么	冬至为什么吃饺子	0
为什么陈继要钻进苇丛里	为什么会出现日食和月食现象	0
什么是气垫船	为什么人可以听见声音	0
为什么有人听不懂古典音乐	为什么耳朵最怕冷	0
为什么郑成功能收复台湾	为什郑成功能收复台湾	1
为什么台风的风眼中没有风	为什么台风的风眼中没有风	1
为什么花有各种不同的颜色	为什么路温舒要把蒲草做成书本	0
核潜艇和普通潜艇的区别是什么	核艇和普通潜艇的区别是什么	1
为什么要限制儿童看电视	为什么要限制儿童看视	1
为什么蔬菜的味道不一样	大气中为什么会出现晕	0
为什么说乌鸦是灭害的功臣	为什么看不见香蕉果实里面的种子	0
为什么说过分限制孩子的活动对其身心发展不利	为什么说过分限制孩子的活动对其身心发展不利	1
为什么叫磨针井	什么是计算机病毒武器	0
运动后肌肉酸痛怎么办	为什么雪莲花不畏冰雪高寒	0
神舟号飞船为什么选在晚上发射	为什么非洲人如此喜爱大胖子树	0
为什么陈继要钻进苇丛里	为什么陈继要钻进苇丛里	1
老虎滩的老虎为什么卧在海中	老虎滩的老虎为么卧在海中	1
人为什么感觉到冷	为什么人工流产会导致不孕	0
你知道普米族人的礼仪和禁忌吗	为什么会出现月食	0
为什么高压电缆的绝缘子是一节节的	为什么鄂温克族人喜欢驯鹿	0
为什么青少年要预防肥胖	为什么说海洋和陆地是会变化的	0
为什么称作一勺之多泉	为什么北极星会指方向	0
驾驶员开车时为什么要系安全带	为什么地球又叫蓝色的星球	0
为什么冬季在养鱼的河面上要凿孔	为什么说画鬼容易画犬难	0
为什么称这棵连株榕树为最大的榕树	为什么称棵连株榕树为最大的榕树	1
为什么小朋友不要多吃油炸的食物	为什么月亮朝着地球那一面是不变的	0
为什么小孩不能吃补品补药	·!!·为什么方承观立志苦学	0
曹操是一代枭雄还是大政治家	曹操是一代枭雄还是大政治	1
为什么无声手枪是无声的	为什么儿童不能喝酒	0
为什么旋转球不走直线	什么旋转球不走直线	1
气压的变化与哪些因素有关	为什么四大名著能经久不衰	0
植物为什么也需要睡大觉	彗星为什么有尾巴	0
为什么蔬菜的味道不一样	北京时间取自哪里	0
为什么同一个玉米棒上会有不同颜色的粒	为什么被称为盐湖之家	0
为什么把台北的热水湖称作酸湖	为什么把台北的水湖称作酸湖	1
猫为什么爱用爪子洗脸	为什么寄居蟹和海葵是好朋友	0
为什么人会出汗	为什么人出汗	1
为什么成人不要搂着孩子睡觉	为什么成人不要搂着孩子睡觉	1
为什么猪笼草是一种最奇怪的草	为什么猪笼草是一种最奇怪的草	1
为什么冬季在养鱼的河面上要凿孔	为什么先看到闪电后听到雷声	0
为什么海水又咸又苦	为什么油着火不能用水灭	0
为什么有的人唱歌跑调	为什么有的人唱歌跑调	1
为什么浓甘油不宜搽脸	叶片为什么会吐水	0
为什么昆虫没有鼻子却嗅觉灵敏	为什么藕有许多小洞洞	0
为什么网络有局域网、城域网和广域网之分	为什么网络有局域网、城域网和域网之分	1
什么是太阳风	为什么弹壳底火被击针一击即发火	0
为什么中国人自称为炎黄子孙	为什么喝粥能滋补身体	0
为什么冰梅石是常州奇观	为什么冰梅石是常州奇观	1
为什么说墨不一定是黑的	什么是小舌	0
电流通过人体吗	为什么生白薯没有烤白薯甜	0
为什么会出现一屋跨两国的情况	彗星为什么有尾巴	0
为什么地球是圆的而地面是平的	为什么地球是圆的而面是平的	1
同样的粘沙土为什么能烧成不同的砖	同样的粘沙土为什么能烧成不的砖	1
为什么苍耳的果实老往人身上粘	为什么苍耳的果实老往人身上粘	1
为什么我国各民族都有传统乐器，你知道是什么吗	为什么我国各民族都有传统乐器，你知道什么吗	1
为什么鳄鱼不属于鱼	海水为什么是咸的	0
为什么虫子飞的时候会嗡嗡地叫	为什么称红楼梦是我国古典长篇小说中最杰出的作品	0
为什么他俩不去评理了	为什么他俩不去评了	1
花灯是流行于哪些民族中的民间歌舞	花灯是流行于哪些民族中的民间歌舞	1
什么是自动手枪	什是自动手枪	1
为什么脱下的衣服不要盖在被子上	为什么鹅兵会作战	0
为什么豆类食品有益健康	为什么刚接的自来水盆里有许多气泡	0
为什么运动时应有意识地使呼吸变得深长和缓慢	为什么指南针有不同的形状，可又总指着南方	0
为什么花有各种不同的颜色	为么花有各种不同的颜色	1
为什么藏族人要在同一天到河里洗澡	为什么藏族人要在同一天到河里澡	1
为什么布朗族人喜欢嚼茶、嚼烟	为什么布朗族人喜欢嚼茶、嚼烟	1
为什么植物要长很长的根	为什么说让婴儿多爬有许多好处	0
如何给纱窗安拉锁	如何给窗安拉锁	1
为什么雨后空气特别好	树叶为什么落下来	0
为什么秦皇岛不是岛	为什么秦皇岛不是岛	1
为什么双双小朋友常出现有意破坏的行为	为什么双双小朋友常出现有意破坏的行为	1
为什么不宜长久呆在空调房间里	为什么宜长久呆在空调房间里	1
为什么早餐很重要	为什么早餐很重要	1
为什么太阳能电池板能够发电	为什么月亮上不能住人	0
为什么磊磊的小飞机能变成机器人	我国的黄土高原上为什么常年覆盖着黄土	0
佛手瓜的种子为什么不能与瓜分开	命题作文为什么要认真审题	0
为什么说台湾是祖国的宝岛	植物是如何开始变绿的	0
为什么满族人院里都立着一根木杆	为什么满人院里都立着一根木杆	1
为什么瓶子里的水不能一下倒出来	为什么有些建筑物样子特别怪	0
为什么要从小预防近视眼	为什么脱下的衣服不要盖在被子上	0
为什么艳丽的花通常没有香气，而香花都是素色的	火车头能做得轻便些吗	0
为什么说加拿大是枫叶之邦	为什么加拿大是枫叶之邦	1
带沙袋进行体育锻炼会得关节炎吗	带沙袋进行体育锻炼会得关节炎吗	1
为什么互联网上要设立防火墙	为什么互联网上要设立火墙	1
为什么杂技演员表演水流星时，水不会洒出来	谢安为什么要批评哥哥	0
火星上有生命吗	火星上有生命	1
为什么湖水夏天浑浊，秋天清亮	彗星会撞上地球吗	0
为什么平平眼睛里的水满了	汽油的90#、93#、97#是什么意思	0
为什么刘勰夜晚要到佛殿读书	为什么刘勰晚要到佛殿读书	1
为什么幼儿会自造新词	为么幼儿会自造新词	1
为什么郭翻受到大家的敬重	为什么摄像机摄像时不需要对焦和曝光	0
为什么汉武帝要独尊儒术	为什汉武帝要独尊儒术	1
为什么有的植物会欺骗	为么有的植物会欺骗	1
为什么苹果皮上会有黑褐色干皮	为什么矮果树产量高	0
为什么植物会啃石头	为什么植物会啃石头	1
为什么都夸鄂伦春族人心眼好	为什么都夸伦春族人心眼好	1
你知道声乐演唱有哪些形式吗	为什么在家里就可以网上购物	0
为什么幼儿对童话故事和童话剧特别感兴趣	为什么有的鱼离开水不会死	0
为什么生白薯没有烤白薯甜	为什么在夏天自行车胎容易放炮	0
为什么昙花开花时间非常短	为什么昙花开花时间常短	1
为什么梵·高最著名的作品是向日葵	为什么梵·高最著名的作品是向日葵	1
为什么聪明的贝贝不会区分各种几何图形	为什么说世界上的东西都是由元素组成的	0
为什么平平眼睛里的水满了	为什么平眼睛里的水满了	1
为什么土族人都喜欢戴毡帽	如何防止冻肉粘连	0
什么是机器人	为什么有时候蜻蜓飞得很低	0
为什么巡航导弹离不开数字化地图	为什么男子会长胡子	0
为什么小手指变成了大拇哥	为什么小手指变成了大拇哥	1
为什么先看到闪后听到雷	为什么说十五分钟是一刻钟	0
为什么中国的许多古建筑上都要雕上龙	为什么运动场上的草皮不怕踩	0
剪了指甲为什么还会长	为什么水上飞机能在海上起降	0
为什么说我国是茶叶的故乡	为什么大理石有各种各样的颜色	0
收音机为什么会有杂音	为什么体育锻炼后尿的颜色有时加深	0
五谷是哪五种农作物	魔鬼谷里的草为什么茂盛	0
为什么孩子肚子疼不能随便吃止疼药	为什么多吃新鲜蔬菜好	0
圣克劳德为什么叫做烟斗之城	圣克劳德为什么叫做烟斗之城	1
怎样合理使用电冰箱	为什么雨点有大有小	0
为什么英国曾被称为日不落帝国	为什么耶路撒冷被称为圣城	0
仡佬族是怎样过仡佬年的	为什么幼儿好动，不易约束自己	0
密度计的刻度为什么是不均匀的	度计的刻度为什么是不均匀的	1
为什么学画素描会遇到很多怪词	为什么陈继要钻进苇丛里	0
为什么羌族人的房顶上立着块石英石	宇航员在太空中怎样称体重	0
为什么人一哭就会流鼻涕	为什么人一哭就流鼻涕	1
为什么白酒有各种不同的酒香	为什么说美洲豹比狮、虎的本领都大	0
藏族的雪顿节是怎么回事	藏族的雪顿节是怎么回事	1
为什么孙子兵法被誉为 兵学鼻祖 	电视机为什么要罩上布套	0
怎样使用互联网	样使用互联网	1
为什么运动前要做准备活动	如何防止冻肉粘连	0
为什么地球是圆的而地面是平的	为什么拉祜族人都喜欢抽烟	0
为什么常眨眼可能是病	怎样培养你的音乐细胞	0
为什么篮球队员中没有1、2、3号队员	为什么篮球队员中没有1、2、3号队员	1
为什么水仙花喝清水就能生长开花	为什么月亮上不能住人	0
车闸不灵活怎么办	车不灵活怎么办	1
为什么房顶上能长出小树小草	为么房顶上能长出小树小草	1
为什么眼睛视力会有变化	为什么眼睛视力会有变化	1
炸药的威力为什么会很大	人是被电吸住了吗	0
为什么狗的嗅觉特别灵敏	为什么狗嗅觉特别灵敏	1
为什么会出现贞观之治	为什么会出现贞观之治	1
暖气片装在哪里好	为什么意大利被称为旅游之国	0
为什么无声手枪是无声的	怎样使用漂白粉	0
什么是和平号空间站	什么是和平号空间站	1
为什么蒙古族人要吃团圆饼	为什么蒙古人要吃团圆饼	1
为什么周幽王要烽火戏诸侯	为什么蜗牛爬行时会留下足迹	0
为什么盲鳗可以吃比它大得多的鱼	为什么盲鳗可以吃比它得多的鱼	1
为什么这盆小菊花格外好看	为什这盆小菊花格外好看	1
飞机上为什么禁用手机	不同的树过冬方法相同吗	0
为什么云有不同的颜色	为什么王允之要故意装醉	0
石油是怎样形成的	为什么小草帽风铃很漂亮	0
为什么称老舍为人民艺术家	纸是怎样生产出来的	0
为什么海水会有涨潮落潮	大蒜为什么能抑菌	0
为什么彩色照片时间久了会褪色	为什么基诺族人喜爱竹子	0
香蕉果实里有种子吗	什么是太阳风	0
为什么称唐伯虎是江南第一风流才子	为什么称唐伯虎是江南第一风流才子	1
为什么马拉松长跑的距离规定为42195米	我爱你用英文怎么说	0
植物的种子和果实会爬行吗	植物的种子和果实会爬行吗	1
手机最怕什么	为什么头发会脱落	0
圣文森特角为什么有天涯海角之称	卢塞恩玻璃宫为什么叫冰川公园	0
鄂温克族是怎样过米阔鲁节的	鄂温族是怎样过米阔鲁节的	1
为什么水是无色的，雪却是白色的	为什么水是色的，雪却是白色的	1
海牛是一种什么动物	语文的含义是什么	0
靖康之变是怎样发生的	为什么说树怕剥皮	0
为什么娜娜会把幼儿园的积木拿回家	为什么娜娜会把幼儿园的积木拿回家	1
为什么切开的茄子放久了表面发黑	为什么山上的松树特别多	0
为什么飞镖的尖鼻子先落地	为什么飞镖的尖鼻子落地	1
!·为什么冬季玻璃杯会炸	为什么海鸟喜欢在海上飞翔	0
为什么说植物的种子是大力士	为什么说植物的种子是大力士	1
为什么奔跑时心脏会剧烈跳动	为什么要定时排尿	0
为什么蟒河那么迷人	什么是微光夜视仪	0
为什么贝类的壳里会生珍珠	为什么把花的叶子摘了，花就死了	0
为什么说钟繇是楷书之祖	为什么湖水夏天浑浊，秋天清亮	0
为什么可乐瓶变成了可乐猪	为什么可乐瓶变成了可乐猪	1
唐宋散文八大家指哪些人	唐宋散文八大家指哪些人	1
宇宙是怎样形成的	宇是怎样形成的	1
核潜艇和普通潜艇的区别是什么	核潜艇和普通潜艇的区别是什么	1
为什么网络有局域网、城域网和广域网之分	为什么网络有局域网、城域网和广域网之分	1
为什么叫墨池	为什么有的蘑菇不能吃	0
塔塔尔族和京族的传统节日是什么	为什么莎莎唱歌喜欢用小沙锤来伴奏	0
为什么王献之能把墨点变母牛	什么是驱逐舰	0
为什么香蕉里看不到种子	为什么叫胜棋楼	0
圣文森特角为什么有天涯海角之称	为什么指南针有不同的形状，可又总指着南方	0
为什么煤层中会有琥珀	为什么说土星是星中美人	0
海鸥为什么总追着轮船飞	海为什么总追着轮船飞	1
为什么盆栽花要换盆	什么盆栽花要换盆	1
爆炸时寂静区是怎样形成的	为什么黄鳝小时候是雌性，长大了却是雄性	0
石油是怎样形成的	为什么盲鳗可以吃比它大得多的鱼	0
给电池充电先要放掉剩余的电，对吗	给电池电先要放掉剩余的电，对吗	1
为什么有的花香，有的花臭	为什么有的花香有的花臭	1
为什么半可燃药筒能被广泛应用	水开后摸壶底,烫手吗	0
为什么哈尼族人特别注重礼貌	为什么物体的重量会变	0
为什么豆腐和菠菜不能一起煮	为什么豆腐和菠菜不能一起煮	1
为什么激光有各种颜色	为什激光有各种颜色	1
为什么向日葵的花总是朝着太阳	为什么傈僳族要过刀竿节	0
为什么坦克也能够用于扫雷	煤和碳是一回事吗	0
为什么老人故意为难张良	气压的变化与哪些因素有关	0
人为什么会上火	人为什么会上火	1
为什么说猩猩最聪明	什么是机器人	0
为什么月亮不会发光却是明亮的	为什么说小行星是恐龙灭绝的元凶	0
为什么说让婴儿多爬有许多好处	为什么说让婴儿多爬有许多好处	1
大爆炸是黑洞吗	大爆炸是黑洞吗	1
为什么沙漠里会有绿洲	为什么白酒有各种不同的酒香	0
为什么叫磨针井	什么是马一角和夏半边	0
螃蟹为什么横着走	螃蟹为什横着走	1
为什么不能吃死鳝鱼	为什么不吃死鳝鱼	1
为什么咖啡能提神醒脑	为什么蛤、蚌里能产珍珠	0
爆炸时寂静区是怎样形成的	为什么刘勰夜晚要到佛殿读书	0
常吃钙片为什么也会缺钙	桌面开裂怎么办	0
为什么鱼会跳出水面	为什么鱼会跳出水面	1
少数民族是怎样巧用箭毒树的	少数民族是怎样巧用箭毒树的	1
为什么皮肤划破后血会自动凝结	为什么皮肤划破血会自动凝结	1
为什么我国北方海岸大多比较平直，南方海岸比较弯曲	水滴落沸油中会怎样	0
注射青霉素前为什么要做皮试	注射青霉素前什么要做皮试	1
为什么榕树能独木成林	为什么榕树能独木成	1
为什么地毯式轰炸是战争中一张王牌	宇宙是什么样子	0
为什么在树枝上睡觉的鸟不会掉下来	为什么在树枝上睡觉的鸟不会掉下来	1
为什么保安族叔叔喜欢在腰间系一把保安刀	怎样用彩色墨水笔涂大块的颜色和配色	0
为什么说与学习音乐相比，学习美术更适合少年儿童的特点	为什么说与学习音乐相比，学美术更适合少年儿童的特点	1
为什么奥运会以五色环为标志	为什么要保护壁虎	0
车闸不灵活怎么办	什么是数字电视	0
胫骨前痛是怎样引起的	胫骨前痛是怎样引起的	1
为什么望远镜能使我们看清远处的东西	为什么望远镜使我们看清远处的东西	1
为什么满族人糊抹了油的窗纸	为什么银河系是条流动的河	0
为什么饮绿茶能消除口臭	为什么炮弹会生虫	0
为什么练单双杠前要用镁粉擦手	为什么藏族人民家家都养牦牛	0
为什么交响乐不容易听懂	为什么交响乐不容易听懂	1
除夕夜为什么家家户户要吃团圆饭	为什么摄像机摄像时不需要对焦和曝光	0
为什么人在剧烈活动后不能马上停下来	为什么一幅好画不能随意改动	0
打哈欠会传染吗	为什么有闪电和雷声	0
为什么指出自己缺点的朋友是好朋友	为什么指出自己缺点的朋友是好朋	1
为什么物体的重量会变	为什么会爆发第二次世界大战	0
什么是宽带	为什么广州也叫羊城	0
为什么茜茜没举手	为什么茜茜没举手	1
什么是反卫星武器	什么是反卫星武器	1
排球运动是怎样产生的	为什么彩电对天线的要求特别高	0
为什么天空会呈现不同的颜色	为什么天空会呈现不同颜色	1
为什么工厂的烟囱要盖得很高很高	为什么有的海洋会发光	0
高科技炮弹有哪些	高科技炮弹有哪些	1
为什么小飞虫总爱在灯下飞来飞去	人在真空中会怎样	0
为什么火箭要垂直发射	皮肤是怎样保持柔软和弹性的	0
植物的种子和果实会爬行吗	为什么有些孩子爱吃泥土、砖头、烂纸、墙皮等	0
为什么说能在做游戏的过程中积累词汇	炒栗子的糖砂有什么功用	0
摩托车的二冲程和四冲程车有什么不同	人为什么感觉到冷	0
为什么有些验血项目需要空腹进行	为什么说颜体被称为楷书第一家	0
为什么门镜又被称作警眼	为什么和尚念经敲的木鱼也是一种乐器	0
秋天的绿叶为什么会变色	秋天绿叶为什么会变色	1
为什么英国的法官和律师要戴假发	为什么大多数人右手的力气比左手大	0
为什么萤火虫会发光	两个相同的塑料袋，一个折起来，一个装满空气，哪个重	0
为什么水槽的下水管常做成弯曲的	为什么传说天上有条银河	0
为什么蛤、蚌里能产珍珠	哈哈镜照人为什么会变样	0
为什么说太阳比地球大	什么是燃料电池	0
为什么月亮有时大，有时小，有时明，有时暗	静电复印机是怎样工作的	0
为什么称我国是种植大豆最早的国家	为什么抑制乙烯的生成和作用，可以贮藏保鲜	0
为什么要站如松，坐如钟	为什么仡佬族人要给牛过生日	0
为什么打野战要穿迷彩服	为什么海参会有分身术	0
为什么长白山是我国产人参最多的地方	为什么超声波能除脏	0
海水为什么是蓝色的	水为什么是蓝色的	1
为什么四面环水的地方叫岛屿	狗为什么要抬腿撒尿	0
为什么花盆底部有个小洞	为什么航空母舰特混编队特别庞大	0
为什么人要睡觉	海水会越来越咸吗	0
为什么要让玩具成为孩子的好伙伴	为什么碰伤的皮肤处会有乌青块	0
为什么幼儿经常自言自语	为什么幼儿经常自言自语	1
为什么在夏天自行车胎容易放炮	为什么叫蜡染布	0
为什么许衡不肯摘梨解渴	为什么要定时排尿	0
为什么会发生八王之乱	静电复印机是怎样工作的	0
为什么人一哭就会流鼻涕	什么树比钢还硬	0
你知道哈萨克族人有哪些礼仪和禁忌吗	为什么相声要引人发笑	0
为什么肥胖者要进低热量饮食	为什么胖者要进低热量饮食	1
哪些锻炼项目有助于矫正八字脚	为什么端午节那天要吃粽子、赛龙舟	0
什么是弹道导弹	为什么说隋炀帝有功有过	0
为什么壁虎能在墙上爬却不掉下来	为什么鱼有淡水鱼、海水鱼之分	0
为什么吉他是人们最喜爱的乐器之一	为什么人造卫星环绕地球的轨道不一样	0
为什么云南大理最大的集市叫三月街	为什么人会出汗	0
雨是怎样形成的	为什么奔跑时心脏会剧烈跳动	0
为什么纳西族人也过火把节	怎样看多幅图写作文	0
为什么冬季夜空中的星星比夏季少	为什么冬季夜空中的星比夏季少	1
阿尔瓦德岛为什么叫美人岛	阿尔瓦德岛为什么叫美人岛	1
为什么夏天不能在中午给花浇水	为什么夏天不能在中午给花浇水	1
为什么用x表示未知数	为什么用x表示未知数	1
为什么幼儿好动，不易约束自己	为什么画人的时候要讲究比例	0
为什么海水会有涨潮落潮	什么是武器的战斗性能	0
为什么冬季夜空中的星星比夏季少	海水为什么是咸的	0
什么是机枪	什么是枪	1
为什么要提倡背诵一些精美的文学作品	为什么肠炎、痢疾常在夏秋季发生	0
为什么幼儿厌恶这位抽烟的阿姨	为什么幼儿厌恶这位抽烟的阿姨	1
为什么翼龙能在空中飞行	为什么翼龙能在空中飞行	1
为什么太阳能晒干衣服却晒不干花草	为什么太阳能晒干衣服却晒不干花草	1
为什么中国画家喜欢在画上题字	为什么夏天星星比冬天多	0
为什么有两个西湖	为什么曹刿能够战胜强大的齐军	0
为什么行星轨道都近似地位于一个平面	为什么行轨道都近似地位于一个平面	1
为什么蛤、蚌里能产珍珠	为什么蛤、蚌里能产珍珠	1
为什么进餐时不应高声谈笑	为什么进餐时不应高声谈	1
为什么听自己录音会觉得声音变了	为什么听自己录音会觉得声音变了	1
为什么非洲人如此喜爱大胖子树	为什么称喊瀑和喊雨	0
为什么纺锤树可以提供自来水	为什么纺锤树可以提供自来水	1
为什么地球内部可以分成许多圈层	为什么地球内部可以分成许多圈层	1
为什么立交桥上会有接缝	为什么立交桥上会有缝	1
为什么有的合唱不用伴奏	为什么小朋友的胳膊容易脱臼	0
为什么月亮上有暗斑	为什么轰炸机被称做天空杀手	0
为什么蛇没有脚却能很快爬行	为什么有些植物散发的气味令人感到清爽	0
为什么多给植物喝水，它反而会死亡	为什么多给植物喝水，它反而会死	1
蒲松龄为什么能写出聊斋志异	什么是微电子学	0
为什么会出现腰椎间盘突出	为什么会出现腰椎间盘突出	1
为什么澳大利亚被称为骑在羊背上的国家	为什么澳大利亚被称为骑在羊背上的国家	1
为什么短跑运动员要下蹲起跑	为什么中国人自称为炎黄子孙	0
为什么桂林山水如此奇丽秀美	为什么比赛前要检测兴奋剂	0
为什么互联网上要设立防火墙	为什么互联网要设立防火墙	1
为什么下雪时不冷，雪融时很冷	为什么植物的种子能无脚走遍天下	0
为什么要学习汉语拼音	为什么小艾虎能打得过大老虎	0
中国人为什么特别钟爱丹顶鹤	中国人为什么特别钟爱顶鹤	1
为什么梵·高最著名的作品是向日葵	为什么颐和园里的铜牛没有尾巴	0
哈尼族有什么礼仪及禁忌	哈尼族有什么礼及禁忌	1
为什么细嫩的幼苗能拱动石板	为什么细嫩的苗能拱动石板	1
为什么有人唱歌声音发抖	为什有人唱歌声音发抖	1
香蕉果实里有种子吗	为什么会出现战国七雄	0
为什么不让皇帝看起居注	大爆炸是黑洞吗	0
为什么说猩猩最聪明	什么说猩猩最聪明	1
为什么说奥地利是音乐王国	为什么说奥地利是音乐王国	1
火箭为什么能在太空中飞行	火箭为什么能在太空中飞行	1
为什么有的鸟腿上套有一个金属环	为什么有的鸟上套有一个金属环	1
为什么饮绿茶能消除口臭	为什么绿茶能消除口臭	1
为什么幼儿常常会破涕为笑	为什么燕子低飞要下雨	0
为什么蒙娜·丽莎的微笑有永恒的魅力	为什么蒙娜·丽莎的微笑有永恒的魅力	1
为什么说小行星是恐龙灭绝的元凶	为什么说小行星是恐龙灭绝的元凶	1
为什么献血不会影响身体健康	为什么叫做莫干山	0
为什么自行车骑得越慢就越容易倒	为什么自行车骑得越慢就越容易倒	1
大豆为什么被称为豆中之王	为什么有的飞机翼尖向上折起	0
世上真有桃花源吗	宇宙是怎样形成的	0
为什么有些植物会指南	为什么有些植物会指南	1
玻璃上的花纹是怎样刻出来的	毛莱是哪个民族的传统体育项目	0
人造卫星为什么会飞出地球	为什么徐湛之要让人先救弟弟	0
为什么墨是文房四宝中的一宝	为什么墨文房四宝中的一宝	1
日本庆祝男孩节为什么要挂鲤帜	给电池充电先要放掉剩余的电，对吗	0
为什么说画鬼容易画犬难	谢安为什么要批评哥哥	0
谁是夏朝第一位国君	谁是夏朝第一位国君	1
你知道魏晋南北朝时期的志怪轶事小说吗	为什么有淡水鱼和盐水鱼之分	0
为什么常常把树干刷成白色	为什么常常把干刷成白色	1
猪为什么用嘴巴拱泥土	猪为什么用嘴巴拱泥土	1
为什么海龟和乌龟不一样	为什么海龟和乌龟不一样	1
为什么可乐瓶变成了可乐猪	为什么蚂蚁不上床了	0
水彩画和水粉画有什么区别	为什么提倡戒烟	0
邮票染了怎么办	为什么韭菜割了以后还能再生长	0
为什么幼儿记不住该记的事	为什么幼儿记不住该记的事	1
为什么叫歌声博物馆	为么叫歌声博物馆	1
为什么合理的膳食应当荤素搭配	为什么我国北方海岸大多比较平直，南方海岸比较弯曲	0
为什么鱼要有鱼鳔	为什么鱼要有鱼鳔	1
达尔文海湾为什么是鸟天下	尔文海湾为什么是鸟天下	1
为什么珊珊小朋友午睡时不上床	为什么珊珊小朋友睡时不上床	1
为什么眼睛视力会有变化	湿袜子为什么粘脚	0
什么是小舌	为什么有的树叶秋天会变红	0
为什么兄弟们不再争吵了	为什么说徐悲鸿是中国美术界的一代宗师	0
为什么迫击炮可以打到山后目标	为什么迫击炮可以打到山后目	1
什么是贫铀弹	为什么月亮朝着地球那一面是不变的	0
蚊子爱叮咬哪些人	为什么维维含着泪又笑了	0
为什么把台北的热水湖称作酸湖	为什么耳朵最怕冷	0
为什么互联网上要设立防火墙	为什么互联网上要设立防火墙	1
为什么不要蒙头睡觉	为什么端午节吃粽子	0
为什么鱼缸里的水草会冒泡	火炮为什么要装注油嘴	0
世上真有桃花源吗	世上有桃花源吗	1
晚香玉为什么夜来香	晚香玉为什么夜来香	1
月亮上是什么样的	为什么做脑电图不会损伤大脑	0
为什么每个人的指纹不一样	为什么每个人的指纹一样	1
山谷的风是怎样形成的	为什么吃菠萝时蘸盐水	0
电视机为什么要罩上布套	为什么有的鱼非常容易钓到	0
为什么张骞要出使西域	为什么张骞要使西域	1
潜水艇为什么能上浮和下沉	潜水艇为什么能上浮和下沉	1
为什么交响乐不容易听懂	为什么金刚石最坚硬	0
缺钙者为什么会抽筋	缺钙者为什么会抽筋	1
为什么不用纯酒精消毒	宝宝为什么总流口水	0
为什么有的幼儿在陌生人和集体面前表现得很胆怵	为什么要限制儿童看电视	0
为什么米仓口里流出许多好大米	为什么米仓口里流出许多好大米	1
苗族有哪些礼仪及禁忌	为什么导弹靠近目标才引爆	0
为什么吸烟会导致脑机能衰退	为什么跳蚤有惊人的跳跃本领	0
为什么物体的重量会变	为什么摘下来的蔬菜会变蔫	0
为什么滑水运动员不会沉入水中	什么是微光电视	0
蒲松龄为什么能写出聊斋志异	为什么哈尼族人特别注重礼貌	0
熊为什么冬眠？冬眠为什么不脱水	晚香玉为什么夜来香	0
为什么浓甘油不宜搽脸	为什么不要躺着看书	0
为什么植物也有寄生虫	为什么迫击炮能击中遮蔽物后的目标	0
为什么吃生鸡蛋不好	为什么吃生鸡蛋不好	1
花生为什么又叫落花生	镜子背面镀的是什么	0
为什么小艾虎能打得过大老虎	为什么小艾虎打得过大老虎	1
电流通过人体吗	电流通人体吗	1
为什么跳水有空中芭蕾之称	为什么脱下的衣服不要盖在被子上	0
为什么李世民会发动玄武门之变	人的阑尾有什么功能	0
牛蛙的肤色为什么会改变	牛蛙的肤色什么会改变	1
为什么他能揭开细腰蜂变化的秘密	为什么他能开细腰蜂变化的秘密	1
少女为什么会来月经	少女为什么会来经	1
为什么要适当地吃粗粮	为什么外国影片中的人物也说的是中国话	0
家用电表分表与总表为什么又误差	!·为什么几片云彩会把整个太阳遮住	0
为什么莎莎唱歌喜欢用小沙锤来伴奏	·!!·什么是戏曲行当的净	0
为什么情绪变化会影响身心健康	为什么情绪变化会影响身心康	1
为什么芳芳变了	为什么说鲸的身上样样都是宝	0
狂犬病是怎么回事	狂犬病是怎么回事	1
为什么把家春秋称为现代红楼梦	为什么夏天下雨前天气特别闷热	0
为什么煤层中会有琥珀	猪为什么用嘴巴拱泥土	0
为什么能利用卫星进行军事侦察	为什么能利用卫星进行军事侦察	1
为什么从冷气间走出来，眼镜会模糊一片	为什么画画要讲立体感、空间感和质感	0
为什么美国犹他州的天然拱比其他任何地方都多	为什么说月亮也可能有卫星	0
你了解哪些植物的趣名	你了解哪些植物的趣名	1
为什么说与学习音乐相比，学习美术更适合少年儿童的特点	为什么电冰箱在停机后不能立刻起动	0
人为什么会上火	为什么宝石是五颜六色的	0
为什么响尾蛇的尾巴会发响	为什么响尾蛇的尾巴发响	1
为什么幼儿特别愿意和玩具小动物说话	为什么幼儿特别愿意和玩具小动物说话	1
为什么这盆小菊花格外好看	为什么幼儿喜欢拆卸玩具	0
为什么多吃新鲜蔬菜好	你会打秋千吗	0
新买来的胶卷为什么外面都包着黑纸	为什么胃液是酸的	0
战略核武器与战术核武器有什么区别	战略核武器与战术核武器有什么区别	1
什么是戏曲行当的生	什么是曲行当的生	1
美国的导弹防御计划是怎样的	怎样使用漂白粉	0
为什么会出现姑娘身上的酒店	为什么会出现姑娘身上的酒店	1
为什么称中冷泉、惠山泉、观音泉为我国最著名的泉	为什么称中冷泉、惠山泉、观音泉为我国最著名的泉	1
为什么胃液是酸的	动物怎样进行自我医疗	0
怎样把开水冷却	怎样把开水冷却	1
为什么苗族有四月八这个节日	为什么头发会脱落	0
为什么云南大理最大的集市叫三月街	为什么云南大理最大的集市叫三月街	1
为什么吐鲁番盆地被称为 火焰山	为什么吐鲁番盆地被称为 火焰山	1
为什么先看到闪电后听到雷声	为么先看到闪电后听到雷声	1
为什么学画素描会遇到很多怪词	为什么李崇将孩子判给苟泰	0
月全食的时候为什么月亮是暗红色	什么是生物战剂	0
为什么弟弟说苹果酸，姐姐说苹果甜	水彩画和水粉画有什么区别	0
少数民族是怎样巧用箭毒树的	数民族是怎样巧用箭毒树的	1
菲菲为什么不让老奶奶走	为什么献血不会影响身体健康	0
烧开水时为什么有声音	火箭升空的瞬间，地面升起的庞大白色气团是什么东西	0
你知道朝鲜族有哪些礼仪和禁忌	你知道朝鲜族有哪些礼仪和禁忌	1
为什么箭毒木又叫见血封喉树	为什么天上的星星有的亮、有的暗	0
水滴落沸油中会怎样	水滴落沸油中会怎样	1
为什么红灯停，绿灯行	为什么说锡林郭勒大草原是美丽富饶的地方	0
为什么要开发组合食品	桌面开裂怎么办	0
为什么鱼雷能在海中不同深度上航行	为什么昆虫会蜕皮	0
什么是导弹艇	为什么预警机要背个大圆盘	0
为什么常绿树能变成落叶树	初学画画的人为什么最好先画水粉画	0
为什么舌头能辨味	为什么海水会有涨潮落潮	0
狂犬病是怎么回事	为什么四大名著能经久不衰	0
科萨培卡沙漠为什么有鬼湖之称	科萨培卡沙漠为什么有鬼湖之称	1
什么是步枪	为什么幼儿不会听反话	0
什么是外来词	鹞式战斗机为什么能垂直起降	0
桌面开裂怎么办	为什么碰伤的皮肤处会有乌青块	0
为什么蓖麻籽不能吃	为什么蓖麻籽不能吃	1
为什么狗认识路	为什么狗认识路	1
为什么朝鲜族人爱吃明太鱼	重金属污染是什么	0
为什么郑板桥能把河中的五彩石夹上来	为什么被蜘蛛吃过的小虫子会剩下空壳	0
为什么不是一个月看到一次日、月食	为什么说墨不一定是黑的	0
为什么在一样的温度下，摸铁和木头觉得冷热不一样	为什么在一样的温度下，摸铁和木头觉得冷热不一样	1
为什么花有各种不同的颜色	为什么有些贝类喜欢生活在石头里	0
为什么叫蜡染布	为什么蜡染布	1
为什么要用三脚插头	为什么北京的古建筑多用九	0
为什么法国被称为浪漫之国	为什么法国称为浪漫之国	1
怎样用彩色墨水笔涂大块的颜色和配色	怎样用彩墨水笔涂大块的颜色和配色	1
为什么蛇能吞下比它的头大得多的食物	狐为什么会给人留下诡计多端的印象	0
为什么说铁树不容易开花	什么是潜艇	0
为什么听自己录音会觉得声音变了	叶片为什么会吐水	0
为什么人站在地球上掉不下来	为什么站在地球上掉不下来	1
为什么有些建筑物样子特别怪	鱼为什么比肉容易坏	0
为什么月亮不会发光却是明亮的	为什么月亮不会光却是明亮的	1
如何自制粘蚊蝇纸条	为什么说诗经是我国最早的诗歌总集	0
人在空中为什么不能再跳第二次	为什么画画时会用眼睛比会用手更重要	0
竹笋为什么有大小年	竹笋为什么有大小年	1
为什么植物生长离不开氮肥	为什么做脑电图不会损伤大脑	0
为什么不能用油料浸洗炮、枪弹	为什么外国影片中的人物也说的是中国话	0
为什么珊珊喜欢用粒粒橙汁罐做小娃娃	为什么珊珊喜欢用粒粒橙汁罐做小娃娃	1
为什么导弹能自动跟踪活动的目标	什么是反义词	0
铁锤为什么砸不坏肚子	为什么猴岛成为旅游中的一个热点	0
为什么跳蚤有惊人的跳跃本领	为什么要用计算机售票	0
为什么小佳佳会盛气凌人	什么是空间武器	0
为什么严寒的南北极也有植物安家落户	为什么我国是世界上农作物起源最早的国家	0
水彩画和水粉画有什么区别	为什么彗星都拖条尾巴	0
为什么壁虎的尾巴容易断	为什么英国曾被称为日不落帝国	0
唐宋八大家是哪几位	唐宋八大家是几位	1
为什么说墨不一定是黑的	为什么司马迁要忍辱著史记	0
为什么中国画常把彩色的东西画成黑白的	为什么中国画常把彩色的东西画成黑白的	1
为什么买不到活的海水鱼	为什么叫马跑泉	0
高空的气温为什么低	高空的气温为什么低	1
为什么有的花香，有的花臭	为什么只有老师没有看见	0
为什么沙发比一般椅子松软有弹性	为什么许衡不肯摘梨解渴	0
为什么世界上第一把小提琴是埃及的音乐家莫可里制造的	为什么有的树叶秋天会变红	0
为什么东西扔上去总会落下来	为什么听自己录音会觉得声音变了	0
为什么会有海上草原、海底森林	为什么叫它拳头木偶	0
为什么说与学习音乐相比，学习美术更适合少年儿童的特点	为什么说与学习音乐相比，学习美术更适合少年儿童的特点	1
白族人有哪些礼仪和禁忌	白族人有哪些礼和禁忌	1
铁饼和标枪运动是怎样产生的	你知道土族有哪些礼仪和禁忌吗	0
雪是怎样形成的	为什么无声手枪是无声的	0
为什么说隋炀帝有功有过	什么说隋炀帝有功有过	1
为什么常绿树能变成落叶树	为什么小手指变成了大拇哥	0
为什么盲鳗可以吃比它大得多的鱼	为什么蜜蜂蜇人后自己也会死掉	0
为什么鸡和鸭有翅膀却飞不高呢	干冰所产生的白雾是什么东西	0
为什么兄弟们不再争吵了	为什么兄弟不再争吵了	1
为什么贺伯颜会受到元世祖的器重	为什么人们尊称陆羽为茶圣	0
为什么说大王花是花中大王	为什么说大王花是中大王	1
果实成熟后为什么会掉下来	为什么受了凉会泻肚子	0
老虎滩的老虎为什么卧在海中	为什么建筑物会是多种多样的	0
花生为什么又叫落花生	为什么雨后，天空中有时会有彩虹	0
为什么病毒可致人于死地	为什么病毒可致人于死地	1
为什么把有的乐队叫交响乐队	为什么艾滋病被称为20世纪的瘟疫	0
除夕夜为什么家家户户要吃团圆饭	为什么会有独头蒜	0
为什么红色印泥不易褪色	为么红色印泥不易褪色	1
卓别林为什么能成为喜剧大师	别林为什么能成为喜剧大师	1
男孩子为什么爱意气用事	男孩子为什么爱意气用事	1
莫斯塔尔城为什么出名	为什么新疆是我国最大的瓜果生产基地	0
强盗为什么会吓得仓惶逃窜	为什么不要边看书报边吃饭	0
为什么夏天人的皮肤上容易长出小红点	为什么夏天人的皮肤上容易长出小红点	1
为什么美术又叫造型艺术	为什么美术又叫造型艺术	1
为什么计算机能够发送传真	为什么有些孩子会挑食和拒食	0
为什么八月十五吃月饼	眼镜腿转动不灵怎么办	0
长颈鹿的脖子为什么那么长	为什么布朗族人喜欢嚼茶、嚼烟	0
为什么小草帽风铃很漂亮	合唱为什么要有指挥	0
叶片为什么会吐水	为什么植物也会螫人	0
分子发动机很小有多小	为什么高山上的风比地面上的大	0
干冰所产生的白雾是什么东西	怎样使笔尖好用	0
为什么在一样的温度下，摸铁和木头觉得冷热不一样	为什么有人唱歌声音沙哑	0
为什么金星最亮	为什么金星亮	1
怎样保存腻子	为什么说螺是建筑奇才	0
什么是太阳风	什么是太阳风	1
成卷的塑料薄膜展开时为什么会吸引毛发	为什么张九龄用鸽子送信	0
为什么冬天的西红柿不如夏天的好吃	为什么行星轨道都近似地位于一个平面	0
为什么在夏天狗总是伸着舌头喘气	为什么在夏天狗总是伸着舌头喘气	1
为什么常眨眼可能是病	为什么常眨眼可能是病	1
为什么雨点有大有小	为什么变压器能改变电压的高低	0
为什么要提倡说普通话	为什么跑弯道的时候要内倾	0
为什么中国人崇尚黄色	为什么植物也会螫人	0
为什么满族人糊抹了油的窗纸	为什么满族人糊抹了的窗纸	1
为什么铁特别容易生锈	为什么铁特别容易生锈	1
为什么要照顾年龄小的伙伴儿	为什么会出现贞观之治	0
为什么用硬笔书写也称书法	肥胖为什么会合并营养不良	0
为什么基诺族人喜爱竹子	为什么弟弟说苹果酸，姐姐说苹果甜	0
为什么睡前要用热水洗脚	为什么睡要用热水洗脚	1
为什么要提倡少年儿童多写自己的生活和心灵世界	为什么旋转球不走直线	0
为什么可以用吸管喝汽水	为什么火车到站后，工人要用锤子在车下敲打	0
蜘蛛是昆虫吗	蜘是昆虫吗	1
用了为什么的句子，后面一定要加问号吗	为什么铝不容易生锈	0
现代银行为什么开始广泛应用计算机	现代银行为什么开始广泛应用计算机	1
元曲四大家 是谁	元曲四大家 是谁	1
为什么月亮上很荒凉	为什么地球会绕轴自转	0
为什么小苏打能代替碱面	什么小苏打能代替碱面	1
人为什么会打嗝	为什么植物会有形形色色的根	0
怎样煮蛋不爆	为什么海龟和乌龟不一样	0
仡佬族是怎样过仡佬年的	为什么有些植物散发的气味令人感到清爽	0
为什么白酒有各种不同的酒香	镪水能自制吗	0
为什么昙花开花时间非常短	为什么昙花开花时间非常短	1
为什么赫哲族人爱穿鱼皮衣	为什么赫哲族人爱穿鱼皮衣	1
人为什么想不开	人为什么想不开	1
为什么不要边看书报边吃饭	为什么被称为盐湖之家	0
为什么受了凉会泻肚子	为什么蓄电池能蓄电	0
为什么花有各种不同的颜色	为什么在一样的温度下，摸铁和木头觉得冷热不一样	0
为什么壮壮小朋友最欣赏柿子儿子	为什么壮壮小朋友最欣赏柿子儿子	1
为什么汉武帝要独尊儒术	为什么情绪变化会影响身心健康	0
元曲四大家 是谁	为什么会有双胞胎	0
为什么温度计也有好几种	猫为什么爱用爪子洗脸	0
为什么徐湛之要让人先救弟弟	为什么徐湛之要人先救弟弟	1
为什么青少年不宜经常开夜车	为什么青少不宜经常开夜车	1
注射青霉素前为什么要做皮试	注射青霉素前为什么要做皮试	1
为什么狗在热天爱伸出舌头	为什么狗在热天爱伸出舌头	1
为什么金星最亮	为什金星最亮	1
为什么情绪变化会影响身心健康	为什么情绪变化会影响身心健康	1
为什么传说天上有十个太阳	为什么半可燃药筒能被广泛应用	0
为什么三脚架重机枪的火线越高射弹散布面积越大	鄂伦春族过春节与赫哲族有什么不同	0
为什么会爆发安史之乱	!·为什么几片云彩会把整个太阳遮住	0
车闸不灵活怎么办	为什么把足球称为世界第一运动	0
为什么他们争着让水桶离自己近一点	为什么人能听到自己的回声	0
甘遂为什么开绿花	为什么不用纯酒精消毒	0
为什么王献之的母亲说他练字三千日，只有一点像羲之	为什么张大千被誉为当代第一大画家	0
为什么肠炎、痢疾常在夏秋季发生	为什么降落伞能使伞兵准确降落	0
为什么血是红色的	昆虫是怎样保护自己的	0
天下第二泉为什么远近闻名	火车头能做得轻便些吗	0
花为什么有各种颜色	为什么很快排除了飞机干扰	0
为什么轰炸机被称做天空杀手	为什么旋转球不走直线	0
彝族人民为什么要过火把节	为什么吃水果也要适量	0
为什么比赛前要检测兴奋剂	为什么松柏树又叫常绿树	0
为什么有的小朋友容易患驼背	为什么有的小朋友容易患驼背	1
为什么马要站着睡觉	为什么马要着睡觉	1
霜是怎样形成的	为什么人造卫星环绕地球的轨道不一样	0
为什么用瓶盖做成的小乐器声音很好听	为什么用瓶盖做成的小乐器声音很好听	1
为什么明明是画却要叫素描	为什么沙锤演奏时发出沙沙的声音	0
为什么受伤的水果会变黑	地球是怎样形成的	0
为什么肥胖者要进低热量饮食	德昂族有哪些礼仪及禁忌	0
为什么给鸡戴红色眼镜可以多产蛋	为什么给鸡戴红色眼可以多产蛋	1
为什么砚是文房四宝中的一宝	为么砚是文房四宝中的一宝	1
八哥在水牛背上啄什么	八哥在水牛背上什么	1
为什么B超能诊断疾病	为什么要用砂锅熬中药	0
为什么已受外力作用的地雷应就地销毁	为什么金沙江畔会有醉汉林	0
蚂蚁从高处落下来为什么摔不死	为什么地球又叫蓝色的星球	0
为什么青铜宝剑不会生锈	为什么岳柱对名画提出批评	0
为什么玲玲和鞋说话	为什么玲玲和鞋说话	1
为什么电冰箱有时嗡嗡响	为什么电冰箱时嗡嗡响	1
哈尼族有什么礼仪及禁忌	电风扇能降低室温吗	0
胖人下滑的速度会比瘦人更快吗	胖人下滑速度会比瘦人更快吗	1
为什么月亮上有暗斑	为什么月亮上有暗斑	1
为什么巨杉是 世界巨木之首	为什么巨杉是世界巨木之首	1
论语是孔子写的吗	论语是孔子写的吗	1
为什么少年也有可能长白发	为什么少年也有可能长白发	1
为什么一般人右手的力气比左手大	为什么日食发生在初一而不是十五	0
为什么叫皮影戏	为什么蓖麻籽不能吃	0
傣族有哪些礼仪和禁忌	傣族有哪些仪和禁忌	1
为什么天王星和海王星看上去呈蓝绿色	为什么柿子有的甜、有的涩	0
什么是高射机枪	为什么他能用手指分辨出糖、盐、碱	0
为什么叶子两面的颜色深浅不同	为什么叶子两面的颜色深浅不同	1
什么是微光夜视仪	什么是微光夜视仪	1
为什么有的年画很有名	什么有的年画很有名	1
为什么沈石田让唐伯虎去游览名山大川	为什么会出现月食	0
为什么火箭要垂直发射	为什么常眨眼可能是病	0
为什么狗在热天爱伸出舌头	水晶眼镜养目吗	0
为什么白酒有各种不同的酒香	分子发动机很小有多小	0
为什么说画人难画手	为什么画人难画手	1
为什么朝鲜族人住的房子没窗户	为什么人可以听见声音	0
圣马可广场为什么那么吸引人	为什么水果有香味	0
为什么叫杂技	为什么叫杂技	1
有头上长角的鱼吗	有头上角的鱼吗	1
为什么山上的松树特别多	为什么山上的松树特别多	1
为什么天空中会出现流星	为什么天空中会出现流星	1
为什么相声要引人发笑	为什么相声要引人发笑	1
秋天的绿叶为什么会变色	秋天的绿叶为什么会色	1
为什么有人弹钢琴老爱出错	怎样把开水冷却	0
为什么糖尿病患者要护脚	为什么糖尿病患者要护脚	1
老虎洞中为什么没有老虎	怎样使肥皂一物多用	0
为什么朝鲜族人爱吃明太鱼	为什么能利用卫星进行军事侦察	0
为什么篮球队员中没有1、2、3号队员	为什么小佳佳会盛气凌人	0
华富里为什么又叫猴城	华富里为什么又叫猴城	1
为什么电风扇能使人感到凉快	自行车是怎样加速运动和刹车的	0
为什么在树枝上睡觉的鸟不会掉下来	为什么宰相管李泌叫小友	0
河流的水是靠什么补给的	河流的水是靠什么补给的	1
恒星的一生是怎样的	恒星的一生怎样的	1
为什么早晨和傍晚的太阳比中午的太阳大	麦奇里湖为什么是世界上的一个奇迹	0
为什么北京人爱看曲艺	为什北京人爱看曲艺	1
为什么用湿布抹冰箱的冰格会被粘着	什么是弹道导弹	0
红糖结块怎么办	红糖结块怎么办	1
武器为什么会出汗	武器为什么会出汗	1
白族人有哪些礼仪和禁忌	族人有哪些礼仪和禁忌	1
为什么珊珊小朋友午睡时不上床	为什么珊珊小朋友午睡时不上床	1
为什么嗅觉有时会失灵	为什么停车信号用红色	0
为什么地球是圆的而地面是平的	为什么地球是圆的而地面是平的	1
为什么陈咸气坏了父亲陈万年	为什么陈咸气坏了父亲陈万年	1
为什么蚂蟥具有医学用途	为什么冬天鸭子在水里不怕冷	0
大炮能把卫星送上天吗	大炮把卫星送上天吗	1
为什么冬天孩子的手和脸容易皴裂	为什么冬天孩子的手和脸容易皴裂	1
为什么升旗时手里的绳子要向下拉	为什么仡佬族人要给牛过生日	0
花为什么有各种颜色	花为什么有各种颜色	1
为什么有的鱼非常容易钓到	为什么有的鱼非常容易钓到	1
为什么说冬冬是个讲信用的好孩子	为么说冬冬是个讲信用的好孩子	1
什么是空空导弹	什么是空空导	1
为什么把天王星称做冷行星	为什么称王莲为 莲中之王	0
宋词主要分为哪两大流派	为什么房顶上能长出小树小草	0
为什么太阳也会死亡	为什么会形成各式各样的岛屿	0
为什么蔡和森挨饿也要读书	套马是哪个民族的传统体育项目	0
为什么火箭顶端要安装一根天线样的钢针	老虎洞中为什么没有老虎	0
为什么会有海上草原、海底森林	为什么会有海上草原、海底森林	1
傣族有哪些礼仪和禁忌	为什么要开发组合食品	0
为什么云南土林给人奇特的感觉	为什么新疆被称为瓜果之乡	0
为什么吃饭时看书不好	为什么说我国的国画是国宝	0
为什么磨刀不误砍柴工	跳雷为什么会跳	0
为什么要培养孩子良好的睡眠习惯	为什么要培养孩子良好的睡眠习惯	1
核潜艇和普通潜艇的区别是什么	为什么弟弟说苹果酸，姐姐说苹果甜	0
为什么沙锤演奏时发出沙沙的声音	为什么沙锤演奏发出沙沙的声音	1
!!·你知道满族的礼节和禁忌吗	为什么昙花开花时间非常短	0
为什么酸奶小杯能称出物体的重和轻	为什么未来的导弹会有思维能力	0
为什么小调皮进入了角色	电视图像为什么会出现重影	0
为什么长跑时呼吸节奏很重要	为什么称红楼梦是我国古典长篇小说中最杰出的作品	0
为什么录像机能自动录像	为什么小朋友的心脏跳动比成人快	0
为什么每天锻炼也消耗不完人的体力	为什么说书法可以体现人的品格与智慧	0
在月经期做劈叉、倒立等活动对身体有害吗	在月经期做叉、倒立等活动对身体有害吗	1
为什么双双小朋友常出现有意破坏的行为	为什么说电脑毕竟不能代替人脑	0
为什么有些植物会指南	如何打开锈锁	0
为什么仡佬族人要给牛过生日	为什么仡佬族要给牛过生日	1
为什么被蜘蛛吃过的小虫子会剩下空壳	为什么被蜘蛛吃过的小子会剩下空壳	1
为什么侦察机能作空中间谍	为什么侦察机能作空间谍	1
莫斯塔尔城为什么出名	为什么要把羊赶出来	0
为什么说美洲豹比狮、虎的本领都大	为什么荆轲刺秦王没有成功	0
扬州八怪怪在何处	达尔文海湾为什么是鸟天下	0
什么是太阳风	什么是太阳风	1
为什么晚上卧室里不宜多放花草	海南沉香是什么	0
为什么云彩不会掉下来	熊为什么冬眠？冬眠为什么不脱水	0
为什么酸奶小杯能称出物体的重和轻	什么是微电子学	0
怎样把开水冷却	为什么战斗机被称作空中霸王	0
为什么篮球队员中没有1、2、3号队员	为什么吕后会乱政	0
蠡园为什么是中外游人迷恋的地方	为什么瑶族人庆祝达努节	0
为什么侦察机能作空中间谍	为什么侦察机能作空间谍	1
为什么易拉罐能变成小工艺品	人为什么会变老	0
为什么说树怕剥皮	为什么说树怕剥皮	1
为什么山上的松树特别多	为什么朝鲜族人爱吃明太鱼	0
做课间操有什么好处	做课间操有什么处	1
为什么要言之有序	为什么玉米根有的长在土壤外	0
为什么要过中秋节	为什么王献之的母亲说他练字三千日，只有一点像羲之	0
为什么主战坦克比普通坦克厉害	为什么主战坦克比普通坦克厉害	1
为什么天上的星星有的亮、有的暗	为什么昙花开花时间非常短	0
为什么云有不同的颜色	宇航员在太空中怎样称体重	0
敌人为什么要杀害罗志群和邓金娣	为什么吃东西要细嚼慢咽	0
为什么要开发组合食品	为什么小佳佳会盛气凌人	0
为什么广州也叫羊城	机枪备用枪管为什么要交替使用	0
为什么有人唱歌声音沙哑	为什么人的皮肤会有不同的颜色	0
纳西族有哪些礼仪和禁忌	西族有哪些礼仪和禁忌	1
为什么青铜宝剑不会生锈	什么是外来词	0
为什么流星会从天上掉下来	为什么星星会发光	0
为什么花瓣都特别漂亮	为什么花瓣都特别漂亮	1
动物怎样进行自我医疗	为什么很多人喜欢听轻音乐	0
为什么响尾蛇的尾巴会发响	为什么磁卡电话能自动计费	0
为什么毛冠鹿的头上没长角	为什么蹲久了站起来就会头晕眼花	0
为什么物体的重量会变	佤族有哪些礼仪和禁忌	0
为什么美术属于视赏艺术	为什么美术属于赏艺术	1
为什么要把自来水塔都造得很高	为什么要把自来水塔都得很高	1
潜水艇为什么能上浮和下沉	高科技炮弹有哪些	0
为什么领港鱼不怕大鲨鱼	为什么小军说自己笨	0
德昂族有哪些礼仪及禁忌	德昂族有哪些礼仪禁忌	1
为什么火箭要垂直发射	为什么铅球的重量是7.257千克	0
为什么要适当地吃粗粮	为什要适当地吃粗粮	1
水族为什么要过端节	水族为什么要过端节	1
为什么受伤的水果会变黑	为什么蚯蚓没有腿和脚却会行走	0
星系会互相吞并吗	星系会互相吞并吗	1
为什么取名为鹅泉	为什么取名为鹅泉	1
世界上有多少种昆虫	界上有多少种昆虫	1
为什么南非被称为黄金之乡	为么南非被称为黄金之乡	1
军用弹药的组成部分有哪些	军用弹药的组成部分有哪	1
人们为什么喜欢到盘山游览	尿是怎么形成的	0
什么是猎雷舰	火山爆发是怎么回事	0
什么是戏曲的唱念做打	什么是曲的唱念做打	1
为什么人会衰老	黄山的怪石上为什么长奇松	0
为什么肥皂能洗掉脏东西	为什么肥皂能洗掉脏东西	1
为什么鸟类有偷东西的嗜好	为什么鸟类有东西的嗜好	1
为什么耳朵辨不清自己的音色	为什么耳朵辨不清自己的音色	1
为什么东北虎的毛色要比华南虎艳丽	为什么说狂草书法起于张、成于素	0
为什么成人不要搂着孩子睡觉	为什么江泌要登房借月	0
为什么三脚架重机枪的火线越高射弹散布面积越大	为什么梵·高最著名的作品是向日葵	0
为什么植物喜欢找气味相投的朋友	为什么植物喜欢找气味相投的朋	1
为什么早晨和傍晚的太阳比中午的太阳大	为什么早晨和傍晚的太阳比中午的太阳大	1
为什么运动时应有意识地使呼吸变得深长和缓慢	为什么孝文帝要改制	0
为什么月亮有时弯，有时圆	中国画为什么要装裱	0
为什么砚是文房四宝中的一宝	为什么砚是文房四宝中的一宝	1
为什么人人要有副整齐的牙齿	纳米材料有什么应用	0
为什么盐水的沸点高	为什么盐水沸点高	1
为什么步枪口径越来越小	什么步枪口径越来越小	1
喇叭为什么变调了	为什么鱼要有鱼鳔	0
冥王星与其它各行星有什么不同	冥王星与其它各行星有什么不同	1
为什么花有大小美丑之分	为什么花有大小美丑之分	1
为什么人吸进氧气，呼出时变成了二氧化碳	为什么人吸进氧气，呼出时变成二氧化碳	1
为什么鲸类有流眼泪的习性	为么鲸类有流眼泪的习性	1
为什么戴胜鸟又叫臭姑鸪	为什么说牡丹是花中之王	0
儿童画为什么不一定是儿童画的	儿画为什么不一定是儿童画的	1
人为什么会打嗝	为什么火山会喷发	0
两个相同的塑料袋，一个折起来，一个装满空气，哪个重	两个相同的塑料袋，一个折来，一个装满空气，哪个重	1
为什么王允之要故意装醉	为什么王允之故意装醉	1
为什么薄薄的圆纸片能立起来	为什么在一样的温度下，摸铁和木头觉得冷热不一样	0
为什么工艺美术深受幼儿园小朋友的喜爱	为什么工艺美术深受幼儿园小朋友的喜爱	1
为什么旋转球不走直线	为什么伤口碰到咸的东西会特别痛	0
为什么北京有那么多有名和好玩的地方	为什么不让皇帝看起居注	0
为什么说秦始皇是中国第一个皇帝	为什么说秦始皇是中国第一个皇	1
做早操有什么好处	做早操有什么好处	1
为什么廷廷认不出那只泥猫了	坚硬的物体也会发生形变吗	0
为什么蚌长期闭着壳不会被饿死	为什么火焰山至今还有唐僧的拴马桩	0
为什么要提倡多读好的课外书	为什么青年人脸上容易生青春痘	0
世界上为什么会有五光十色的湖	为什么张溥把自己的书房叫作七录书斋	0
刚出锅的鸡蛋为什么不烫手	为什么亚当桥不同于一般的桥	0
为什么藏族人民家家都养牦牛	为什么藏族人民家家都养牦牛	1
为什么凹镜中看到的图像是倒置的	为什么凹镜中看到的图像是倒置的	1
为什么竹子长得特别快	为什么幼儿会出现不是自己错也承认错的现象	0
为什么彩色照片时间久了会褪色	什么是隐形手枪	0
你能让铅笔尖向下直立在手指上吗	你能让铅笔尖向下直立在手指上	1
为什么在温度表上有下限而无上限呢	为什么在温度表上有下限而无上限呢	1
为什么狗的嗅觉特别灵敏	为什么狗的嗅觉特别灵敏	1
美国的导弹防御计划是怎样的	为什么苗族有四月八这个节日	0
为什么酸奶小杯能称出物体的重和轻	为什么酸奶小杯能称出物体的重和轻	1
为什么火焰山至今还有唐僧的拴马桩	仡佬族是怎样过仡佬年的	0
为什么患肾炎的人仍能参加体育活动	为什么患肾炎的人仍能参加体育活	1
为什么导弹能自动跟踪活动的目标	为什么导弹能自动跟踪活动的目标	1
螃蟹为什么横着走	为什么房间里洒了水会凉快些	0
为什么说徐悲鸿是中国美术界的一代宗师	树叶为什么落下来	0
为什么淝水之战中东晋军能以少胜多	为什么淝水之战中东晋军能以少胜多	1
为什么犀牛鸟能和凶猛的大犀牛成为好朋友	中国画为什么有工笔画和写意画之分	0
为什么篮球队员中没有1、2、3号队员	为什么篮球队员中没有1、2、3号队员	1
为什么晚上卧室里不宜多放花草	为什么晚上卧室不宜多放花草	1
为什么要提倡背诵一些精美的文学作品	为什么磁卡电话能自动计费	0
为什么蛇的舌头总是伸出来	为什么蛇的舌头总伸出来	1
为什么曹丕命令曹植在七步之内作诗一首	为什么曹丕命令曹植在七步之内作诗一首	1
为什么红海的海水是红色的	电扇转快时为什么象在倒转	0
为什么自己挠胳肢窝不会痒	为什么桂林山水如此奇丽秀美	0
为什么摸了核桃的青皮，手会黑	大爆炸是黑洞吗	0
人们为什么喜欢到盘山游览	飞机里新鲜空气哪里来	0
为什么小鸡刚出壳就会走路和吃东西	为什么小鸡刚出壳就会走路和吃西	1
为什么幼儿会出现不是自己错也承认错的现象	为什么冬天会有霜	0
为什么彩色照片时间久了会褪色	为什么蓖麻籽不能吃	0
为什么山洞有冷暖之分	为什山洞有冷暖之分	1
为什么叫姑嫂塔	红、黄、蓝为什么被称为三原色	0
为什么鸡蛋不能吃太多	佛手瓜的种子为什么不能与瓜分开	0
为什么秋天、冬天会有雾	为什么有的植物会欺骗	0
为什么有时太阳周围会出现彩色光圈	隐形飞机为什么能隐形	0
为什么基诺族人喜爱竹子	为什么基诺族人喜爱竹子	1
什么是鱼雷艇	人为什么会发笑	0
为什么植物也会螫人	秋天为什么大雁往南飞	0
为什么铁特别容易生锈	为什么铁特别容易锈	1
宇宙空间有温度吗，是多少	为什么说音乐能寓教于乐	0
为什么梅花鹿身上的梅花会变	为什么梅鹿身上的梅花会变	1
绘画大家庭中为什么会有漫画	画大家庭中为什么会有漫画	1
为什么叫它拳头木偶	为什么不用刀切木头，而用锯锯木头	0
为什么说要用心去观察	为什么张骞要出使西域	0
沙漠是怎样形成的	为什么武则天会留下无字碑	0
为什么新疆被称为瓜果之乡	为什么步枪口径越来越小	0
彗星为什么有尾巴	为什么卫卫给老师厉害的回击	0
为什么要制造潜水航空母舰	什么是气垫船	0
为什么吕后会乱政	为什么吕后会乱政	1
什么是宽带	叶片为什么会吐水	0
你知道世界上最大的核潜艇吗	你知道世界上最大的核潜艇吗	1
节食为什么不减肥反而增肥	为什么电灯泡会发光	0
什么是冲锋枪	什么是冲锋枪	1
烧开水时为什么有声音	为什么蜘蛛能织网	0
为什么仡佬族人要给牛过生日	!!·你知道满族的礼节和禁忌吗	0
哪些锻炼项目有助于矫正八字脚	节食为什么不减肥反而增肥	0
为什么万里长城要设烽火台	V字手势的来源是什么	0
号称绿色陷阱的沼泽是怎样形成的	为什么马戏团的小狗能算算术	0
为什么有的小朋友容易患驼背	为什么有的小友容易患驼背	1
为什么湖水夏天浑浊，秋天清亮	地磁场变化吗,它变化会有什么影响	0
为什么能听到对牧师做的忏悔	为什么能听到对牧做的忏悔	1
少女峰为什么成为著名的游览区	少女峰为什么成为著名的游览区	1
宇航员在太空中怎样称体重	为什么有些磺胺类药要与小苏打合用	0
自行车倒千斤怎么办	自行车倒千斤怎么办	1
为什么新疆是我国最大的瓜果生产基地	什么是黑客	0
为什么北极星会指方向	为什么北极星会指方向	1
为什么主战坦克比普通坦克厉害	为什么主战坦克比普通坦克厉	1
为什么说画鬼容易画犬难	为什么在家里就可以网上购物	0
冥王星与其它各行星有什么不同	冥王星与其它各星有什么不同	1
用什么办法寄那些怕摔碰、怕雨淋的东西	为什么管这种熊又叫浣熊	0
为什么冰块能漂在水面上	果实成熟后为什么会掉下来	0
为什么有些建筑物样子特别怪	为什么会下冰雹	0
为什么有的树能自己长出来	为什么有的树自己长出来	1
牙齿是怎样分类的	为什么月亮上不能住人	0
冰川是如何形成的	川是如何形成的	1
游泳时耳朵进了水怎么办	游泳耳朵进了水怎么办	1
为什么白天看不见星星	雾是怎样形成的	0
为什么叫胜棋楼	火炮为什么要装注油嘴	0
为什么东西扔上去总会落下来	什么是戏曲的唱念做打	0
飞机为什么能飞	飞机为什么能飞	1
手机最怕什么	为什么艾滋病被称为20世纪的瘟疫	0
人造卫星为什么会飞出地球	为什么说树叶是最简易的吹奏乐器	0
为什么切掉一只肾的人还能活着	为什么响尾蛇的尾巴会发响	0
为什么外国影片中的人物也说的是中国话	为什么外国影片中的人物也说的是中国话	1
为什么激光有各种颜色	为么激光有各种颜色	1
为什么冰岛被称为冰与火的国度	为什么吃饭时看书不好	0
为什么流星会从天上掉下来	为什么流星会从天上掉下来	1
为什么说要用心去观察	为什么说要用心去观察	1
为什么只有老师没有看见	为什么只有老师没有看见	1
动物怎样进行自我医疗	为什么可以用吸管喝汽水	0
为什么孟母三次搬家	为什么孟母三次家	1
电流通过人体吗	电流通过人吗	1
为什么隐形飞机也会有克星	为什么隐形飞机也会有克星	1
为什么水果不都是甜的	为什么月亮上不能住人	0
吃带鱼要去鳞吗	吃带鱼去鳞吗	1
铁饼和标枪运动是怎样产生的	为什么叫磨针井	0
月亮为什么沿着奇怪的轨道绕地球转	为什么变色龙善于变色	0
为什么说隋炀帝有功有过	为什么说隋炀帝功有过	1
为什么指南针能指南	为什么天空会呈现不同的颜色	0
为什么叫音乐电话	为什么藏族人腰间有一个大口袋	0
为什么说乌鸦是灭害的功臣	为什么说乌是灭害的功臣	1
谢安为什么要批评哥哥	谢安为什么批评哥哥	1
为什么演员跳踢踏舞时脚下会发出很响的声音	为什么演员踢踏舞时脚下会发出很响的声音	1
为什么称李白为诗仙	为什么称李白为仙	1
鄂温克族是怎样过米阔鲁节的	鄂温克族是怎过米阔鲁节的	1
为什么立交桥上会有接缝	为什么立交桥上有接缝	1
什么是反卫星武器	大蒜为什么能抑菌	0
阿尔瓦德岛为什么叫美人岛	阿尔瓦岛为什么叫美人岛	1
为什么会爆发安史之乱	老虎洞中为什么没有老虎	0
为什么测量山的高度要以海平面为标准	为什么南海的小岛数也数不清	0
为什么说海洋和陆地是会变化的	为什么冰山被称为海洋杀手	0
汽油的90#、93#、97#是什么意思	沙漠是怎样形成的	0
畲族有什么礼仪及禁忌	鲁迅为什么要塑造阿Q这个人的形象	0
热是什么	为什么蟋蟀会用翅膀唱歌	0
为什么王允之要故意装醉	为什么刚接的自来水盆里有许多气泡	0
为什么已排除的化学地雷应运到安全地点处理	为什么雅鲁藏布江谷地有地热资源	0
为什么说手枪是防身的最好武器	为什么说手枪是防身的最好器	1
为什么不能给花浇凉开水	为什么昙花开花时间非常短	0
为什么胃液是酸的	为什么胃液是酸	1
美术的含义是什么	为什么要提倡背诵一些精美的文学作品	0
为什么孩子会得肠虫病	为什么孩会得肠虫病	1
为什么鱼离不开水	火箭是怎样飞上天的	0
墙皮为什么会出汗	树叶为什么落下来	0
为什么把台北的热水湖称作酸湖	露是怎样形成的	0
为什么常喝鸡汤有助于治疗皮肤病	冰为什么这么滑	0
为什么要提倡背诵一些精美的文学作品	为什么要提倡背诵一些精美的文学作品	1
纸是怎样生产出来的	为什么叫它拳头木偶	0
为什么毛笔要用动物身上的毛来做	为什么老人故意为难张良	0
为什么制导炮弹能精确打击目标	为什么运动后不想立即吃饭	0
高科技炮弹有哪些	高科炮弹有哪些	1
为什么被蜘蛛吃过的小虫子会剩下空壳	为什么伙伴们要嘲笑陈胜	0
狗为什么要抬腿撒尿	为什么打野战要穿迷彩服	0
活树建筑为什么倍受青睐	活树建筑为什么倍受青睐	1
为什么有人唱歌声音发抖	笔杆上的小孔有什么功用	0
什么是地空导弹	为什么说并不一定要成为美术家才学习美术	0
为什么说台湾是祖国的宝岛	为什么战斗机被称作空中霸王	0
怎样保存腻子	怎样保存子	1
为什么把台北的热水湖称作酸湖	什么把台北的热水湖称作酸湖	1
为什么望远镜能使我们看清远处的东西	卓别林为什么能成为喜剧大师	0
为什么要多吃鱼	为什么不能用油料浸洗炮、枪弹	0
为什么天空中会出现流星	为什么天空中会出流星	1
为什么夏天人的皮肤上容易长出小红点	为什么有的植物开花，有的植物不开花	0
为什么阴天时看不见太阳	为什么阴天时看不见太阳	1
为什么近视镜的度数应该及时调整	火车汽笛为什么变化?浅谈多普勒效应	0
为什么要保护壁虎	为什么要保护壁虎	1
为什么长颈鹿的脖子特别长	为什么长颈鹿的子特别长	1
老年人怎样自我检查	老年人怎样自我检查	1
为什么比赛前要检测兴奋剂	为什么比赛前要检测兴奋剂	1
气压的变化与哪些因素有关	为什么壮族人民把歌节定为三月初三	0
为什么鱼离不开水	为什么鱼离不开水	1
猫为什么爱用爪子洗脸	猫为什爱用爪子洗脸	1
什么是数字电视	为什么在黑暗中猫能捉到老鼠	0
你了解气门芯吗	你了解气门芯吗	1
为什么蓄电池能蓄电	为什么寄居蟹和海葵是好朋友	0
为什么柿子有的甜、有的涩	为什么柿子有的甜、有的涩	1
为什么有些植物会指南	为什么大多数人右手的力气比左手大	0
如果人们能够进入贯穿地球的隧道中，将发生什么事情	什么是外来词	0
为什么头发会脱落	为什么萤火虫会发光	0
为什么跑弯道的时候要内倾	为什么叫皮影戏	0
松树为什么要流泪	松为什么要流泪	1
为什么说海洋和陆地是会变化的	为什说海洋和陆地是会变化的	1
为什么说植物的种子是大力士	为什么说我国是茶叶的故乡	0
为什么榕树能独木成林	为什么禹凡突然不愿来幼儿园	0
为什么兄弟们不再争吵了	为什么铅笔伸进水就像是断了	0
为什么可乐瓶变成了可乐猪	为什么小飞虫总爱在灯下飞来飞去	0
孩子为什么同家长疏远了1	什么是宽带	0
为什么有人把可可树称作软黄金	中国画为什么有很多画线条的方法	0
为什么铁特别容易生锈	为什么铁特别容易生	1
为什么立交桥上会有接缝	为什么立交桥上有接缝	1
为什么吃生鸡蛋不好	为什么吃豆腐最好配点海带	0
昆虫怎样吃东西	为什么韭菜割了以后还能再生长	0
为什么用海水洗衣服时不能用肥皂	为什么用海水洗衣服时不能用肥皂	1
海南沉香是什么	为什么说黑枣不是枣	0
静电复印机是怎样工作的	为什么投降举白旗	0
为什么会产生龙卷风	为什么瑞士被称为钟表王国	0
玻璃上的花纹是怎样刻出来的	被疯狗咬伤怎么办	0
怎样用彩色墨水笔涂大块的颜色和配色	怎样用彩色墨水笔涂大块的颜色和配色	1
为什么核大战会产生核冬天	为什么核大战会产生核冬天	1
热是什么	热是么	1
高科技炮弹有哪些	为什么韦嗣立的母亲会受到感动	0
为什么弹壳底火被击针一击即发火	为什么植物的根向下生长，茎向上生长	0
为什么说齐白石是我国近代艺术大师	为什么生活在贝壳里的动物叫软体动物	0
重金属污染是什么	为什么宰相管李泌叫小友	0
水彩画和水粉画有什么区别	水彩画水粉画有什么区别	1
为什么冰川会流动	为什么冰川会流动	1
为什么珊珊喜欢用粒粒橙汁罐做小娃娃	常吃钙片为什么也会缺钙	0
为什么要提倡背诵一些精美的文学作品	为什么大连的贝雕最好	0
为什么阴天湖水会冒泡、变浑	为什么茶树都生长在南方	0
为什么焦尾琴的尾部有烧焦的痕迹	鱼为什么比肉容易坏	0
为什么张骞要出使西域	为什么冰雹出现在暖季	0
为什么会发生海啸	为么会发生海啸	1
气压的变化与哪些因素有关	彝族有什么礼仪与禁忌	0
为什么不赞成青少年饮酒	为什么不赞成青少饮酒	1
军用弹药的组成部分有哪些	军用药的组成部分有哪些	1
为什么张大千被誉为当代第一大画家	蚊子爱叮咬哪些人	0
为什么用冷水洗脸能预防感冒	气象,资源卫星通常在什么轨道上	0
为什么地球是圆的而地面是平的	为什么治疗肠虫病要用安乐士	0
为什么燕子低飞要下雨	为什么要重视孩子的眼外伤	0
为什么他能用手指分辨出糖、盐、碱	为什么他能用手指分辨出糖、盐、碱	1
湖泊是怎样形成的	湖泊是怎样形成	1
!·为什么寒冷的冬天鸟也不怕冷	为什么升旗时手里的绳子要向下拉	0
为什么小熊猫总长不大	人们六次登上月球在那里都发现了什么	0
海鸥为什么总追着轮船飞	海鸥为什么总追轮船飞	1
为什么三脚架重机枪的火线越高射弹散布面积越大	为什么三脚架重机枪的火线越高射弹散布面积越大	1
为什么要用鼠标	为什么要用鼠标	1
什么是布雷舰	为什么鸟类有偷东西的嗜好	0
为什么能用瓶子奏出曲子来	为什么能用瓶子奏出子来	1
为什么种子煮熟后就不能发芽	什么种子煮熟后就不能发芽	1
为什么核大战会产生核冬天	火炮为什么要装注油嘴	0
为什么岳柱对名画提出批评	为什么岳柱对名画提出批评	1
为什么用海水洗衣服时不能用肥皂	为什么用水洗衣服时不能用肥皂	1
怀孕后为什么要少吃米饭	人为什么会上火	0
为什么立交桥上会有接缝	为什么被蜜蜂螫刺后，皮肤的红肿和疼痛会不断加剧	0
中国画为什么有工笔画和写意画之分	中国画为什么有工笔画和写意画之分	1
羊多利是怎样被制造出来的	羊多利是怎样被制造出来的	1
为什么航母上的官兵要穿上五颜六色的军服	为什么萌萌向爸爸要香烟盒	0
你知道人声有哪些类别吗	你知道人声有哪些类别	1
为什么树木能把人吃掉	为什么互联网上要设立防火墙	0
怎样合理使用电冰箱	自行车倒千斤怎么办	0
为什么壁虎能在墙上爬却不掉下来	为什么壁虎能在墙上却不掉下来	1
为什么电影中受伤的镜头像真的一样	为什么昆虫没有鼻子却嗅觉灵敏	0
·!!·什么是戏曲行当的净	为什么有人听不懂古典音乐	0
做早操有什么好处	为什么犀牛鸟能和凶猛的大犀牛成为好朋友	0
荧火虫为什么会发光	荧火虫为什会发光	1
邮票染了怎么办	邮票染怎么办	1
为什么短跑运动员经常拉伤大腿后面的肌肉	电扇转快时为什么象在倒转	0
宇宙是什么样子	宇宙是什么样子	1
为什么曹丕命令曹植在七步之内作诗一首	为什么曹丕命令曹植在七步之内作诗一首	1
为什么拨浪鼓的声音很好听	怎样煮蛋不爆	0
为什么曹丕命令曹植在七步之内作诗一首	为什么小儿易出现肠套叠	0
爬云梯的梯子短一些是否更安全	胃切除后为什么还能消化食物	0
为什么赫哲族人爱穿鱼皮衣	为什么计算机会产生千年虫问题	0
为什么明明是画却要叫素描	为什么明明是画却要素描	1
为什么短跑运动员穿上钉子鞋参加比赛时跑得就快	为什么飞鱼会飞	0
什么是黑客	什么是黑	1
为什么瓶子里的水不能一下倒出来	为什么瓶子里的水不一下倒出来	1
什么是高射机枪	什么高射机枪	1
为什么彩电对天线的要求特别高	为什么献血不会影响身体健康	0
什么是导弹艇	为什么星星有不同的颜色	0
猜猜他在干什么	猜猜他在什么	1
为什么射击时对不同距离的目标要定不同的表尺	为什么射击时对不同距离的目标要定不同的表尺	1
为什么常绿树能变成落叶树	为什么称老舍为人民艺术家	0
为什么大禹能够治水成功	为什么狗认识路	0
为什么会出现日食和月食现象	为什么出现日食和月食现象	1
为什么头发会脱落	为什么头发会脱落	1
为什么狼的眼睛会闪闪发光	为什么鱼离不开水	0
为什么有的植物能连生在一起	为什么大禹能够治水成功	0
俄罗斯族有什么礼仪及禁忌	为什么蜜蜂蜇人后自己也会死掉	0
中国画为什么有很多画线条的方法	中国画为什么有很多线条的方法	1
为什么彩色胶卷能拍出彩色照片	为什么彩色胶卷能拍出彩色照片	1
老虎洞中为什么没有老虎	老虎洞中什么没有老虎	1
无声手枪为什么会无声	蚂蚁从高处落下为什么摔不死	0
斑马身上的花纹有什么用	为什么雨后空气特别好	0
为什么管金丝猴叫精灵鬼	为什么管金丝猴叫精灵鬼	1
为什么王安石要变法	为什么王安石要变法	1
怎样用可乐瓶做小姑娘的裙子	为什么小朋友容易被烫伤	0
为什么俄罗斯族人用面包和盐迎接客人	为什么火箭和飞机的头部是尖的	0
为什么星星会发光	生长着的花、果香味为什么与采摘下的不同	0
为什么树会发出笑声	为什么幼儿教育小学化的方式会降低幼儿大脑功能	0
为什么肥皂能洗掉脏东西	为什么王献之能把墨点变母牛	0
为什么能用鸽子送信	为什么会产生龙卷风	0
为什么地球又叫蓝色的星球	为什么说我国是世界上盐湖最多的国家	0
为什么水雷能自动跟踪目标	为什么水雷能自动跟踪目标	1
为什么早晨和傍晚的太阳比中午的太阳大	为什么要用三脚插头	0
为什么会下雾	为什么会下雾	1
家用电表分表与总表为什么又误差	为什么我国人民要在喜庆节日放鞭炮	0
猫为什么爱用爪子洗脸	为什么有些建筑物样子特别怪	0
为什么说太阳离我们很远很远	为什么要学习格言	0
为什么被称为盐湖之家	为什么被称为盐湖之家	1
怎样辨别名词、动词和形容词	鱼雷是怎样击中目标的	0
为什么伤口碰到咸的东西会特别痛	为什么伤口碰到咸的东西会特别痛	1
长颈鹿的脖子为什么那么长	长颈鹿的子为什么那么长	1
为什么望远镜能使我们看清远处的东西	为什么望远镜能使我们看清远处的东	1
肥皂为什么能产生泡沫	为什么触摸屏能对人的触摸作出反应	0
为什么不要轻易切除孩子的扁桃体	为什么花瓣都特别漂亮	0
商店里为什么有很多面镜子	为什么戏曲表演中有些演员要画花脸	0
为什么生物武器令人感到恐怖	为什么生物武器令感到恐怖	1
为什么会有鼓，鼓有什么用	为什么新疆被称为瓜果之乡	0
为什么要学习汉语拼音	黑色和白色也是配不出来的颜色，为什么不叫原色呢	0
冰川是如何形成的	为什么房顶上能长出小树小草	0
人造卫星为什么会飞出地球	为什么只有企鹅能在南极安家	0
狗为什么要抬腿撒尿	为什么要抬腿撒尿	1
为什么伤口愈合时会觉得痒	为什么月亮朝着地球那一面是不变的	0
唐宋散文八大家指哪些人	为什么海带不会开花结籽也能繁殖	0
水族为什么要过端节	为什么舌头能辨味	0
为什么仡佬族人要给牛过生日	为什么仡佬族人要给牛过生日	1
为什么舌头能尝出味道来	植物怎样对付昆虫的蚕食	0
鄂伦春族过春节与赫哲族有什么不同	鄂伦春族过春节与赫哲族有什么不同	1
为什么纳西族人也过火把节	为什么纳西族人也过火把节	1
为什么切开的茄子放久了表面发黑	为什么体操运动员要在手上涂白色粉末	0
为什么彩色照片时间久了会褪色	为什么彩色照片时间久了会褪色	1
为什么不宜长久呆在空调房间里	喇叭为什么变调了	0
月亮上是什么样的	月上是什么样的	1
给电池充电要先放掉剩余的电，对吗	为什么植物的根向下生长，茎向上生长	0
大雪后为什么很寂静	大雪后为什么很寂静	1
大炮能把卫星送上天吗	为什么伤口碰到咸的东西会特别痛	0
为什么天空中的云总是变化，空中的云是从哪儿来的	为什么天空中的云总是变化，空中的云是从哪儿来的	1
为什么知了的鸣叫声显得单调刺耳	核潜艇和普通潜艇的区别是什么	0
为什么抑制乙烯的生成和作用，可以贮藏保鲜	冰为什么这么滑	0
为什么壮族人民把歌节定为三月初三	为什么小草长得特快、特别多	0
为什么要定时排尿	为什么要定时排尿	1
为什么地球中心热,怎样测其温度	为什么向日葵的花总是朝着太阳	0
为什么康县令判郗珍无罪	为什么响尾蛇的尾巴会发响	0
为什么美国犹他州的天然拱比其他任何地方都多	为什么美国犹他州的然拱比其他任何地方都多	1
为什么说植物是我们的朋友	为什么植物是我们的朋友	1
石油是怎样形成的	石油是怎样成的	1
为什么篮球队员中没有1、2、3号队员	谁是最有影响的发明人	0
剪了指甲为什么还会长	猫为什会埋大便	0
为什么不能用果汁服药	怀孕后为什么要少吃米饭	0
为什么雨天电话容易串音	为什么仫佬族人要过吃虫节	0
为什么要让小朋友尽早学会用筷子	为什么要让朋友尽早学会用筷子	1
海南沉香是什么	海南沉香是什么	1
为什么说吴昌硕是开启一代画风的画家	为什么吐鲁番盆地被称为 火焰山	0
为什么小草帽风铃很漂亮	为什么小草帽风铃很漂亮	1
为什么喷气式飞机烧煤油而不烧汽油	为什么舌头能尝出味道来	0
为什么地球又叫蓝色的星球	你知道魏晋南北朝时期的志怪轶事小说吗	0
为什么唱歌喉音重不好听	为什么唱歌喉音重不好听	1
商店里为什么有很多面镜子	商店里为什么有很多面镜子	1
为什么鸟巢能吃呢	为什么螺是建筑奇才	0
为什么月亮不会发光却是明亮的	为什么月亮不会发光却是明亮的	1
高空的白雾带是怎样形成的	高空的白雾带是怎样成的	1
为什么植物要长很长的根	为什么植物要很长的根	1
为什么法国被称为浪漫之国	为什么哈密瓜特别甜	0
为什么毛南族人喜欢毛南三宝	为什么路温舒要把蒲草做成书本	0
哪些锻炼项目有助于矫正八字脚	哪些锻炼项目有助于矫正八字脚	1
敌人为什么要杀害罗志群和邓金娣	人为什么要杀害罗志群和邓金娣	1
为什么不能在玻璃上滑冰	为什么不能在玻璃上滑冰	1
为什么老师一下子就知道了来客是谁	果实成熟后为什么会掉下来	0
为什么有的鸟腿上套有一个金属环	为什么沙漠里会有绿洲	0
为什么空气并不空	为什么很多人喜欢听轻音乐	0
为什么蚂蚁不上床了	为什么娜娜会把幼儿园的积木拿回家	0
为什么水星上没有大气层	为什么微光电视可以进行战场监视	0
游泳时耳朵进了水怎么办	游泳时耳朵进了水怎么办	1
为什么变压器能改变电压的高低	为什么画画要画得满	0
为什么说大自然里有音乐	为什么说大自然里有音乐	1
阅读中碰到不懂的文言词汇该怎么办	为什么拨浪鼓的声音很好听	0
为什么说隋炀帝有功有过	为什么会发生泥石流	0
飞机为什么能飞	飞机为什么能飞	1
为什么松柏树又叫常绿树	为什么瓶子里的水不能一下倒出来	0
为什么传统办法可以对付卫星侦察	为什么传统办法可对付卫星侦察	1
什么是反义词	谢安为什么要批评哥哥	0
为什么山上的松树特别多	为什么山上的松树特别多	1
为什么盐水的沸点高	什么盐水的沸点高	1
地球为什么会自转	为什么蛤、蚌里能产珍珠	0
肚子饿了为什么会叫	为什么管金丝猴叫精灵鬼	0
蜡烛为什么能被吹灭	蜡烛为什么能被吹灭	1
为什么有的墙用空心砖来砌	铁饼和标枪运动是怎样产生的	0
为什么彩色照片时间久了会褪色	为什么瓶子里的水不能一下倒出来	0
商店里为什么有很多面镜子	商店里为什么有很多镜子	1
为什么侦察机能作空中间谍	什么是航天飞机，它在军事上有哪些用途	0
为什么戴胜鸟又叫臭姑鸪	什么是舰载机	0
为什么徐光启要把棉株尖顶上的嫩芽掐断	为什么徐光启要把棉株尖顶的嫩芽掐断	1
为什么巡航导弹离不开数字化地图	命题作文为什么要认真审题	0
体温表为什么采用水银	为什么停车信号用红色	0
为什么幼儿经常自言自语	为什么幼儿经常自言自语	1
人为什么会上火	人为什么会上火	1
为什么投降举白旗	为什么投降举白旗	1
为什么看林人是森林纵火犯	为什么看人是森林纵火犯	1
为什么颐和园里的铜牛没有尾巴	为什么颐和园里的牛没有尾巴	1
什么人适合吃人参	为什么用扇子扇炉火越扇越旺，而扇蜡烛却一扇就灭	0
为什么海蜇会螫人	什么是贬义词	0
为什么沙发比一般椅子松软有弹性	为什么鲸不是鱼	0
为什么怒族人用溜索过河	为什么中国的筷子驰名世界	0
如何打开锈锁	如何打开锈锁	1
为什么摸了核桃的青皮，手会黑	火星上有生命吗	0
为什么北京人爱看曲艺	为什么幼儿经常自言自语	0
为什么哈萨克族人喜欢冬不拉	为什么幼儿会出现不是自己错也承认错的现象	0
为什么有人弹钢琴老爱出错	为什么司马迁要忍辱著史记	0
为什么不能在玻璃上滑冰	为什么不能在玻上滑冰	1
为什么练单双杠前要用镁粉擦手	为什么练单双杠前要用镁粉擦手	1
为什么说美洲豹比狮、虎的本领都大	为什么说牡丹是花中之王	0
五谷是哪五种农作物	五谷是哪五种农作物	1
为什么细嫩的幼苗能拱动石板	什么是气垫船	0
重金属污染是什么	给电池充电要先放掉剩余的电，对吗	0
为什么黑墨不能当染布的颜料	为什么被蜜蜂螫刺后，皮肤的红肿和疼痛会不断加剧	0
为什么不要轻易切除孩子的扁桃体	为什么文彦博要往树洞里灌水	0
为什么冬天暖房要开窗子	为什么冬天暖房要开窗	1
为什么月亮有月相变化	为什么说她是聪明的小姑娘	0
为什么很多人喜欢听轻音乐	为什么夏天的夜晚还那么热	0
为什么长白山是我国产人参最多的地方	盆地是怎样形成的	0
为什么有的植物会欺骗	为什么幼儿常常会破涕为笑	0
为什么迫击炮能击中遮蔽物后的目标	为什么有的树能自己长出来	0
为什么电风扇能使人感到凉快	人为什么会长头发	0
冬天树叶落地时为什么一般正面对地	为什么人参有滋补作用	0
卢塞恩玻璃宫为什么叫冰川公园	为什么会有独头蒜	0
为什么雨从天空落到地上	为什么雨从天空落到上	1
为什么应该培养随手查字典的习惯	太阳为什么会有太阳黑子	0
为什么昙花开花时间非常短	为什么脑子会越用越灵	0
为什么一幅好画不能随意改动	为什么纸盒做的小火车能拐弯	0
为什么医生要使用听诊器	为什么孩子会得肠虫病	0
为什么浓甘油不宜搽脸	人们六次登上月球在那里都发现了什么	0
为什么中国人自称为炎黄子孙	为什么中国自称为炎黄子孙	1
为什么彩虹的七色顺序总是不变	为什么王羲之被奉为书圣	0
竹笋为什么有大小年	为什么人有头皮屑	0
为什么眼镜蛇发怒时脖子会变粗	为什么眼镜蛇发怒时脖子会变粗	1
运动后肌肉酸痛怎么办	为什么红灯停，绿灯行	0
为什么要重视孩子的眼外伤	为什么要重视孩子的眼外伤	1
植物为什么也需要睡大觉	植物为什么也需要睡大觉	1
为什么有些磺胺类药要与小苏打合用	为什么有磺胺类药要与小苏打合用	1
什么是贫铀弹	什么是贫铀弹	1
为什么说剪纸是一门中国的古老艺术	邮票染了怎么办	0
为什么天上的星星有的亮、有的暗	为什么天上的星星数不清	0
海菊花为什么不是花	为什么水星上没有水	0
蜡烛为什么能被吹灭	为什么故宫是最大的宫殿	0
什么是生物战剂	胖人为什么更易饥饿	0
为什么内蒙古举行那达慕大会时那么热闹	为什么蚂蚁不上床了	0
为什么核大战会产生核冬天	果树为什么有大小年	0
为什么有的人唱歌跑调	为什么有的人歌跑调	1
为什么说台湾是祖国的宝岛	为什么飞镖的尖鼻子先落地	0
干冰所产生的白雾是什么东西	为什么说甲骨文是中国最早的书法艺术	0
军用弹药的组成部分有哪些	为什么夏天星星比冬天多	0
为什么称李白为诗仙	为什么有些孩子爱吃泥土、砖头、烂纸、墙皮等	0
为什么金刚石最坚硬	风是怎样形成的	0
有些坦克炮的抽烟装置为什么偏置	为什么夏天星星比冬天多	0
什么是数字电视	么是数字电视	1
为什么少年长白发	植物怎样抵御动物的侵害	0
大蒜为什么能抑菌	中国人为什么特别钟爱丹顶鹤	0
为什么用湿布抹冰箱的冰格会被粘着	为什么用湿布抹冰箱的冰格会被粘着	1
什么是布雷舰	什么是布舰	1
为什么铅球的重量是7.257千克	为什么铅球的重是7.257千克	1
为什么录像机能自动录像	风是怎样形成的	0
为什么桂林山水甲天下	为什么响尾蛇的尾巴会发响	0
为什么说缝叶莺是灵巧的缝纫女	为什么说缝叶莺是灵巧的缝纫女	1
号称绿色陷阱的沼泽是怎样形成的	为什么轰炸机被称做天空杀手	0
为什么必需血型相同才能输血	为什么蛇的舌头总是伸出来	0
甘遂为什么开绿花	为什么八月十五吃月饼	0
为什么大理石有各种各样的颜色	为什么大理石有各种各样的颜色	1
常规潜艇为什么不能长时间在水下	常规潜艇为什么不能长时间水下	1
为什么盆栽花要换盆	为什么盆栽花要换盆	1
为什么耶路撒冷被称为圣城	为什么青年人脸上容易生青春痘	0
为什么周扒皮家的鸡半夜就叫	为什么不是一个月看到一次日、月食	0
为什么会出现日食和月食现象	为什么岳柱对名画提出批评	0
重金属污染是什么	铁饼和标枪运动是怎样产生的	0
为什么红色印泥不易褪色	为什么白天看不见星星	0
如何自制粘蚊蝇纸条	为什么刚掀开的冷冻啤酒瓶口会冒出雾气	0
为什么娜娜会把幼儿园的积木拿回家	松树为什么要流泪	0
人为什么会变老	为什么彩色照片时间久了会褪色	0
彝族人民为什么要过火把节	植物怎样抵御动物的侵害	0
太阳为什么会有太阳黑子	太为什么会有太阳黑子	1
气象,资源卫星通常在什么轨道上	气象,资源卫星通常在什么轨道上	1
为什么有时候蜻蜓飞得很低	为什么有时候蜻蜓得很低	1
五谷是哪五种农作物	五是哪五种农作物	1
为什么称作一勺之多泉	为什么称作一勺之多泉	1
为什么门镜又被称作警眼	为什么门镜又被称作警眼	1
什么是粒子束武器	为什么核检查有不同的方法	0
为什么地球在转，而我们却感觉不到	为什么地球在转，而我们却感觉不到	1
为什么盲鳗可以吃比它大得多的鱼	人为什么要经常眨眼	0
郎世宁对中国传统绘画有何影响	郎世宁对中国传统画有何影响	1
为什么儿童团长王璞能抓住特务	为什儿童团长王璞能抓住特务	1
为什么吃饭时说话会呛着	动物为什么不会迷失方向	0
为什么金刚石最坚硬	桌面开裂怎么办	0
蛇为什么喜欢在春天蜕皮	为什么小海马不是海马爸爸生的	0
为什么世界上第一把小提琴是埃及的音乐家莫可里制造的	重金属污染是什么	0
为什么植物也有寄生虫	为么植物也有寄生虫	1
猫为什么爱用爪子洗脸	为什么狮子大王收到的是一袋水	0
为什么弹壳底火被击针一击即发火	跳台滑雪运动起源于哪儿	0
为什么传说天上有条银河	熊为什么冬眠？冬眠为什么不脱水	0
为什么上党人参会失踪	为什么螃蟹要吐沫	0
为什么花盆底部有个小洞	为什么花盆底部有个小洞	1
什么是舰载机	什么是舰载机	1
为什么马戏团的小狗能算算术	为什么在夏天自行车胎容易放炮	0
为什么美国犹他州的天然拱比其他任何地方都多	为什么美国犹他州的天然拱比其他任何地方都多	1
为什么火焰山至今还有唐僧的拴马桩	为什火焰山至今还有唐僧的拴马桩	1
有关节炎的人能参加剧烈运动吗	有关节炎的人能参加剧烈运动吗	1
为什么肖思话决心改恶从善	为什么称聊斋志异是中国古典文学短篇小说的代表作	0
为什么戴碧荣会失去左臂和左腿	为什么戴碧荣会失去左臂和左腿	1
为什么雌黄鳝会变成雄黄鳝	为什么雌黄鳝会变雄黄鳝	1
为什么云有各种不同的颜色	高科技炮弹有哪些	0
为什么杂技演员表演水流星时，水不会洒出来	什么是粒子束武器	0
为什么白天看不见星星	为什白天看不见星星	1
为什么会下雾	怎样清扫水泥地	0
水开后摸壶底,烫手吗	为什么火箭要垂直发射	0
为什么壮族人民把歌节定为三月初三	为什么有的树能自己长出来	0
为什么互联网上要设立防火墙	为什么互联网上要设立防火	1
为什么人在打呵欠时会眼泪汪汪	为什么人在打欠时会眼泪汪汪	1
为什么长吻鱼喜欢接吻	人为什么会长头发	0
为什么说海狸是水下工程师	冬天运动时出汗要注意什么	0
为什么鸡和鸭有翅膀却飞不高呢	为什么鸡和鸭有翅膀却飞不高呢	1
水开后摸壶底,烫手吗	为什么冬季在养鱼的河面上要凿孔	0
为什么蚯蚓是植物的好朋友	为什么蚯蚓是植物的朋友	1
为什么蛇的舌头总是伸出来	为什么蛇的舌头总是伸出来	1
为什么磕头虫会磕头	为什么他俩不去评理了	0
为什么有些孩子会挑食和拒食	什么有些孩子会挑食和拒食	1
你知道羌族有哪些礼仪和禁忌	你知道羌族有哪些礼仪和禁忌	1
为什么墨是文房四宝中的一宝	为什么鱼会跳出水面	0
什么是宇宙尘？它们从哪里来	儿童画为什么不一定是儿童画的	0
什么是对牛弹琴和对马弹琴	什么是微电子学	0
郎世宁对中国传统绘画有何影响	为什么冷饮不可多吃	0
高科技炮弹有哪些	湿袜子为什么粘脚	0
为什么已受外力作用的地雷应就地销毁	纸放时间长了为什么变黄	0
为什么双双小朋友常出现有意破坏的行为	为什么月亮会从云里钻来钻去	0
为什么萌萌拆半导体	为什么萌萌拆半导体	1
为什么坦克火炮在颠簸中能打得准	为什么坦克火炮在颠簸中能打得	1
为什么肉汤凉得较开水慢	为什么短命菊是植物中生命最短的	0
你知道人声有哪些类别吗	为什么说海洋和陆地是会变化的	0
为什么三脚架重机枪的火线越高射弹散布面积越大	为什么盐水的沸点高	0
鱼雷是怎样击中目标的	鱼雷是怎样击中目标的	1
为什么植物的根向下生长，茎向上生长	为什么植物的根向生长，茎向上生长	1
为什么孩子晚上睡觉容易出汗	海洋为什么会变成红色	0
为什么人造卫星环绕地球的轨道不一样	为什么不能用沙子去扑灭燃烧的炸药	0
为什么变色龙善于变色	为什么变色龙善于变色	1
为什么边尔村的泉被称为神泉	为什么边尔村的泉被称为神泉	1
为什么防毒面具能防毒	唐宋八大家是哪几位	0
星系会互相吞并吗	卢塞恩玻璃宫为什么叫冰川公园	0
为什么说我国是茶叶的故乡	为什么说乌鸦是灭害的功臣	0
为什么说吴昌硕是开启一代画风的画家	为什么小儿易出现肠套叠	0
什么是全球定位系统	为什么称喊瀑和喊雨	0
为什么话剧演员要必修音乐课	黑色和白色也是配不出来的颜色，为什么不叫原色呢	0
为什么英国曾被称为日不落帝国	为什么英国曾被称为日不落帝国	1
为什么在飞机上禁止使用移动电话	为什么在飞机上禁止使用移动电	1
微波炉是怎样把食物加热的	为什么迫击炮能击中遮蔽物后的目标	0
为什么幼儿会出现不是自己错也承认错的现象	为什么幼儿会出现不是自己错也承错的现象	1
为什么大多数人右手的力气比左手大	怎样用大蒜治蚊虫叮咬	0
为什么说拉斐尔的西斯廷圣母是最美的圣母像	胖人下滑的速度会比瘦人更快吗	0
敌人为什么要杀害罗志群和邓金娣	缺钙者为什么会抽筋	0
春天的萝卜为什么会糠	为什么坦克也能够用于扫雷	0
为什么说埃及金字塔是古代文明史上的奇迹	为什么埃及金字塔是古代文明史上的奇迹	1
打哈欠会传染吗	傣族有哪些礼仪和禁忌	0
卫星是怎样发射的	卫星是怎发射的	1
红场为什么不能算世界上最大的广场	红场为什么不能算世界上最大的广场	1
为什么红色印泥不易褪色	人造卫星为什么会飞出地球	0
为什么猫的眼睛一日三变	为什么猫的眼睛一日三变	1
刚出锅的鸡蛋为什么不烫手	刚出锅的鸡蛋为什么不烫手	1
为什么巨杉是 世界巨木之首	为什么巨杉是 世界巨木之首	1
为什么壁虎的尾巴容易断	为什么虎的尾巴容易断	1
为什么进餐时不应高声谈笑	为什么月亮有时大，有时小，有时明，有时暗	0
为什么说京剧是我们的国宝	为什么把台北的热水湖称作酸湖	0
为什么有时枪会胀膛炸膛	为什么称我们的国家是诗国	0
为什么激光武器有很强的杀伤力	为什么叫它拳头木偶	0
为什么月亮会从云里钻来钻去	为什么人的一生要长两副牙齿	0
为什么花癫患者都是青少年	为什么知了的鸣叫声显得单调刺耳	0
为什么受伤的水果会变黑	为什么有的海洋会发光	0
为什么兵马俑坑是名胜古迹	为什么兵马俑坑是名古迹	1
为什么蜗牛爬行时会留下足迹	人为什么能感到鲜味	0
为什么白薯叶子会结薯	独龙族是怎样过卡秋哇节的	0
人们为什么喜欢到盘山游览	为什么他们能顺利通过独木桥	0
!·为什么人们喜欢看孔雀舞	为什么侦察机能作空中间谍	0
自行车是怎样加速运动和刹车的	为什么反坦克地雷是坦克的克星	0
楔式炮闩体为什么做成棱柱形	楔式炮闩体什么做成棱柱形	1
为什么说美术可以提高观察能力	火箭和导弹是一回事吗	0
为什么吃冰淇淋要适可而止	为什么吃冰淇淋要适可而止	1
雾是怎样形成的	为什么有的树叶秋天会变红	0
为什么凡事要自己亲自试一试	为什么凡事要自己亲自试一试	1
什么是机器人	为什么吴昂自愿住进牛棚	0
唐宋散文八大家指哪些人	唐宋散文八大家指哪些人	1
为什么大理石有各种各样的颜色	为什么保安族叔叔喜欢在腰间系一把保安刀	0
为什么不用刀切木头，而用锯锯木头	为什么不用切木头，而用锯锯木头	1
蠡园为什么是中外游人迷恋的地方	蠡园为什么是中外游人迷恋的地方	1
黑色和白色也是配不出来的颜色，为什么不叫原色呢	为什么北京的古建筑多用九	0
为什么说画人难画手	为什么说画人难画	1
为什么黄鳝小时候是雌性，长大了却是雄性	为什么自行车比赛选手要走之字形路线	0
为什么肥皂能清洗手部的脏污	为什么要开除冥王星	0
红潮有什么危害	傣族有哪些礼仪和禁忌	0
如何给纱窗安拉锁	剪了指甲为什么还会长	0
为什么能听到对牧师做的忏悔	为什么叫书法	0
为什么花也要睡觉	为什么互联网上要设立防火墙	0
为什么火箭要垂直发射	为什么海水是咸的	0
为什么双双小朋友常出现有意破坏的行为	为什么双双小朋友常出现有意坏的行为	1
为什么会出现战国七雄	流星雨怎么形成的	0
为什么要把自来水塔都造得很高	为什么火箭顶端要安装一根天线样的钢针	0
为什么要提倡背诵一些精美的文学作品	怎样使用漂白粉	0
为什么海龟能认识回故乡的路	为什么海龟能认识回故的路	1
为什么不让踩草坪	为什么听自己录音会觉得声音变了	0
为什么不宜带幼儿到公共场所活动	为什么藕有许多小洞洞	0
为什么一条电话线路上可以通多路电话	为什么晚上捕鱼用灯能引诱鱼群	0
人在空中为什么不能再跳第二次	人在空中为什么不能再跳第二次	1
为什么人参那么珍贵	为什么会有奥林匹克运动会	0
为什么说四川省的铁树林是我国最大的铁树林	什么说四川省的铁树林是我国最大的铁树林	1
为什么会爆发安史之乱	大气可分为哪几层	0
什么是发射窗口和发射场	什么是发射窗口和发射场	1
为什么说甲骨文是中国最早的书法艺术	怎样用可乐瓶做小姑娘的裙子	0
为什么要在花盆里放些空蛋壳	喇叭为什么变调了	0
为什么说中国是风筝的故乡	为什么冰山被称为海洋杀手	0
邮票染了怎么办	邮票染了怎么	1
为什么有些贝类喜欢生活在石头里	为什么有些贝类喜欢生在石头里	1
为什么说诗经是我国最早的诗歌总集	为什么诗经是我国最早的诗歌总集	1
为什么植物间有相亲和相克的关系	为什么植物间有相亲和相的关系	1
跳雷为什么会跳	为什么每个人的指纹不一样	0
为什么叫它拳头木偶	为什么要在花盆里放些空蛋壳	0
为什么把从我国到古罗马国的路称作丝绸之路	为什么沈石田让唐伯虎去游览名山大川	0
为什么说部首一般都是偏旁，而偏旁不一定是部首	为什么旋转球不走直线	0
为什么花盆底部有个小洞	为什么月亮上不能住人	0
你知道魏晋南北朝时期的志怪轶事小说吗	你知道魏晋南北朝时期的志怪轶事说吗	1
为什么我国古代的书刻在石头上	海菊花为什么不是花	0
荧火虫为什么会发光	为什么吸尘器可以吸走灰尘	0
为什么大蒜能杀菌	什么是气垫船	0
无声手枪为什么会无声	为什么说西游记是一部浪漫主义杰作	0
为什么陈毅把墨当糖吃了	语文的含义是什么	0
为什么韩愈买来一根蜡烛	什么是黑洞	0
为什么说京剧是我们的国宝	海牛是一种什么动物	0
为什么可以用吸管喝汽水	为什么不能用果汁服药	0
为什么有人弹钢琴老爱出错	为什么有人弹琴老爱出错	1
为什么头发会脱落	为什么人体的左右不对称	0
为什么不能给花浇凉开水	为什么不能给花浇凉水	1
狂犬病是怎么回事	竹笋为什么有大小年	0
怎样看多幅图写作文	用了为什么的句子，后面一定要加问号吗	0
怎样清扫水泥地	为什么戏曲表演中有些演员要画花脸	0
声音会跳吗	声音会跳吗	1
人是怎样消化食物的	人是怎样消化食物的	1
有的沿海岛屿降水为什么比邻近大陆还少	有的沿海岛屿水为什么比邻近大陆还少	1
为什么犀牛鸟能和凶猛的大犀牛成为好朋友	为什么幼儿喜欢拆卸玩具	0
为什么蝙蝠是哺乳动物	谁是夏朝第一位国君	0
声音会跳吗	为什么称李白为诗仙	0
果树为什么有大小年	什么是布雷舰	0
为什么意大利被称为旅游之国	为什么说木卫二上可能有生命	0
彗星会撞上地球吗	为什么会藕断丝连	0
油画为什么要用油来调颜色	油画为什么要用油来调颜	1
为什么说徐悲鸿是中国美术界的一代宗师	为什么说齐白石是我国近代艺术大师	0
为什么受了凉会泻肚子	为什么小朋友的胳膊容易脱臼	0
为什么颜料有透明不透明的区别	为什么面对幼儿做示范动作时应镜面示范	0
为什么说人类离不开植物的光合作用	为什么说人类离不开植物的光合作用	1
为什么基诺族要过特毛且节	海水为什么是咸的	0
吃水果为什么不能代替吃蔬菜	吃水果为什么不能代替吃蔬菜	1
怎样培养你的音乐细胞	小孩为什么要唱儿童歌曲不要唱大人歌曲	0
摩托车的二冲程和四冲程车有什么不同	为什么蔬菜的味道不一样	0
为什么叫它植树鸟	什么叫它植树鸟	1
为什么表演快板书要边说边打竹板	为什么表演快板书要边说边打竹板	1
尿是怎么形成的	尿是怎么形的	1
楔式炮闩体为什么做成棱柱形	为什么毕达哥拉斯定理又称为勾股定理	0
为什么蚂蚁要爬到喜鹊的身上	为什么蚂蚁要爬到喜鹊身上	1
为什么米芾的字写得那样好	为什么米芾的字写得那样好	1
为什么蚂蚁要爬到喜鹊的身上	为什么闵子骞受了继母的虐待，却还要原谅她	0
为什么藏族人腰间有一个大口袋	为什么禹凡突然不愿来幼儿园	0
为什么吃豆腐最好配点海带	为什么铅球的重量是7.257千克	0
牙齿是怎样分类的	牙齿是怎分类的	1
收音机为什么会有杂音	收音机为什会有杂音	1
为什么说大自然里有音乐	为什么会爆发第二次世界大战	0
为什么要坚持写片断	海牛是一种什么动物	0
为什么树会发出笑声	为什么树会发出笑声	1
为什么大、小兴安岭及完达山是我国最大的森林基地	为什么有的墙用空心砖来砌	0
中国人为什么特别钟爱丹顶鹤	为什么生物武器令人感到恐怖	0
为什么雅鲁藏布江谷地有地热资源	为什么雅鲁藏布谷地有地热资源	1
为什么鱼要有鱼鳔	为什么冬天枯死的草，春天能发芽	0
为什么要过中秋节	为什么张大千被誉为当代第一大画家	0
为什么天空会呈现不同的颜色	为什么天空会呈现不同的颜色	1
什么是航天飞机，它在军事上有哪些用途	为什么丁丁病了还坚持要去幼儿园	0
为什么蚂蟥具有医学用途	为什么要制造潜水航空母舰	0
为什么练单双杠前要用镁粉擦手	果实成熟后为什么会掉下来	0
水杉是名副其实的世界爷吗	为什么说我国是茶叶的故乡	0
为什么木星有小太阳系的美称	为什么说奥地利是音乐王国	0
为什么熊猫的爪是六指儿	为什么熊猫的爪是六指儿	1
为什么榕树能独木成林	电流通过人体吗	0
怎样用树叶制书签	为什么在夏天自行车胎容易放炮	0
海洋为什么会变成红色	为什么久坐久站脚会发麻	0
为什么说太阳是太阳系的家长	为么说太阳是太阳系的家长	1
为什么飞机在空中也可以加油	换气空调的功能是什么，有什么作用	0
为什么恒星会发光	为什么不宜长久呆在空调房间里	0
为什么汉武帝要独尊儒术	为什么汉帝要独尊儒术	1
为什么人们不能直接吃河豚	为什么人们不能直接吃河豚	1
为什么老奶奶要磨铁棒槌	为什么宝石是五颜六色的	0
为什么潜艇在水下能认路	郎世宁对中国传统绘画有何影响	0
为什么蟒河那么迷人	为什么焰火会有不一样的颜色	0
为什么把大兴安岭称为林海	为什么海边的白天和黑夜温度变化不大呢	0
为什么画画时会用眼睛比会用手更重要	分子发动机很小有多小	0
无声手枪为什么会无声	用四氯化碳灭火要注意什么	0
什么是数字电视	为什么人有脉博	0
为什么铁特别容易生锈	为什么铁特容易生锈	1
少女为什么会来月经	少女为什么来月经	1
为什么沙漠里会有绿洲	牛蛙的肤色为什么会改变	0
怎样用比较的方法审题	怎样用较的方法审题	1
为什么苗族有四月八这个节日	为什么苗族有四月八这个节日	1
为什么有人唱歌声音发抖	饺子或肉丸煮熟了为什么会浮起来	0
为什么济南又名泉城	为什么鉴真和尚要东渡日本	0
为什么说大王花是花中大王	铅球出手的角度应该是多少	0
为什么要用Email	为什么要用Email	1
为什么大理石有各种各样的颜色	为什么大理石有各种各样的颜色	1
为什么孩子肚子疼不能随便吃止疼药	为什么孩子肚子疼能随便吃止疼药	1
为什么盆栽花要换盆	为什么曹丕命令曹植在七步之内作诗一首	0
为什么叫歌声博物馆	为什么说他是聪明的小皇帝	0
为什么太阳照的地方，小朋友会感到暖和	为什太阳照的地方，小朋友会感到暖和	1
高空的气温为什么低	为什么兄弟们不再争吵了	0
积累词汇有哪些途径	积累词汇有哪些途径	1
为什么乌龟身上会出汗	为什么小明选择了雪	0
为什么说我国是世界上盐湖最多的国家	为什么伤口愈合时会觉得痒	0
为什么纸盒做的小火车能拐弯	为什么最热的地方不在赤道	0
为什么怪石被称为大象石	什么是军用机器人	0
卓别林为什么能成为喜剧大师	热是什么	0
为什么坦克也可以架桥开路	剥切葱时为什么会流泪	0
牙齿是怎样分类的	为什么满族人糊抹了油的窗纸	0
为什么包拯被称为铁面包公	为什么包拯被称为铁面包公	1
有些坦克炮的抽烟装置为什么偏置	你知道朝鲜族有哪些礼仪和禁忌	0
为什么冬季夜空中的星星比夏季少	在什么条件下，月球会变成淡红色	0
唐宋八大家是哪几位	唐宋八大家是哪几位	1
为什么说晨晨最勇敢	为么说晨晨最勇敢	1
植物是如何开始变绿的	密度计的刻度为什么是不均匀的	0
为什么热水瓶能保温	为什么热水瓶能保温	1
为什么蔡和森挨饿也要读书	为什么近视镜的度数应该及时调整	0
为什么要重视孩子的眼外伤	为什么要重视孩子的眼伤	1
胫骨前痛是怎样引起的	为什么说有办法能把海水里的盐去掉	0
为什么战斗机被称作空中霸王	为什么战斗机被称作空中霸王	1
商店里为什么有很多面镜子	商店里为什么有很多面镜子	1
为什么要把羊赶出来	为什么要把羊赶出来	1
为什么要学习格言	为什么猪笼草是一种最奇怪的草	0
为什么游泳时必须用嘴吸气	为什么美术属于视赏艺术	0
带沙袋进行体育锻炼会得关节炎吗	带沙袋进行体育锻炼会得关节炎吗	1
为什么冬天鸭子在水里不怕冷	为什么会有海上草原、海底森林	0
为什么流星会从天上掉下来	为什么种子煮熟后就不能发芽	0
清明节为什么是我国的传统节日	小孩为什么要唱儿童歌曲不要唱大人歌曲	0
为什么鹅兵会作战	为什么鹅兵会作战	1
新买来的胶卷为什么外面都包着黑纸	为什么新疆是我国最大的瓜果生产基地	0
为什么幼儿常常会破涕为笑	恒星的一生是怎样的	0
为什么恒星会发光	为什么恒星会光	1
为什么端午节吃粽子	为什么端节吃粽子	1
为什么油棕有世界油王的美称	为什么要多吃鱼	0
为什么肉汤凉得较开水慢	跳雷为什么会跳	0
商店里为什么有很多面镜子	为什么夏天的夜晚还那么热	0
为什么瓶子草是食虫的最特殊的植物	为什么哈密瓜特别甜	0
为什么不要随手扔掉可乐瓶	为什么不要随手扔掉可乐瓶	1
为什么苗族有四月八这个节日	为什么苗族有四月八这个节日	1
为什么自行车比赛选手要走之字形路线	为什么碰伤的皮肤处会有乌青块	0
为什么主战坦克比普通坦克厉害	畲族有什么礼仪及禁忌	0
怎样才能把这四样东西分开	蠡园为什么是中外游人迷恋的地方	0
人在空中为什么不能再跳第二次	在空中为什么不能再跳第二次	1
青蛙的大嘴巴有什么用	为什么孙登要放掉背弹弓的青年	0
为什么他把幼儿园的书带回家了	为什么他把儿园的书带回家了	1
为什么捕蝇草是最奇特的草	为什么看鱼鳞能知道鱼的年龄	0
怎样使用互联网	怎样使用互网	1
为什么毛南族人喜欢毛南三宝	为什么毛南族人喜欢毛南三	1
为什么会有海上草原、海底森林	为什么会有海上草原、海底林	1
古城为什么定名为无锡	为什么傈僳族要过刀竿节	0
为什么月亮上很荒凉	为什么月亮上很荒凉	1
秋天的绿叶为什么会变色	为什么月亮有时弯，有时圆	0
为什么说中国的书法和绘画是一对兄弟	为什么变色龙善于变色	0
火车汽笛为什么变化?浅谈多普勒效应	火车汽笛为什么变化?浅谈多普勒效应	1
商店里为什么有很多面镜子	商店里为什么有很多面子	1
你知道羌族有哪些礼仪和禁忌	为什么冰雹出现在暖季	0
为什么武则天会留下无字碑	为什么武则天会留下无碑	1
为什么幼儿常常会破涕为笑	八个电池是怎样连接的	0
为什么小草长得特快、特别多	为什么小草长得特快、特别多	1
果树为什么有大小年	果树为什有大小年	1
小朋友唱的歌曲为什么有前奏和间奏	小朋友唱的歌曲为什么有前奏和间奏	1
为什么细嫩的幼苗能拱动石板	为什么鼻子能闻出各种气味	0
人们六次登上月球在那里都发现了什么	为什么碰伤的皮肤处会有乌青块	0
为什么李贺让母亲担忧	为什么李贺让母亲担忧	1
为什么大蒜能杀菌	为什么大蒜能杀菌	1
为什么澳大利亚被称为骑在羊背上的国家	为什么电子琴能模拟其他乐器的声音	0
什么是反坦克导弹	什么是反坦克导弹	1
为什么吃捣烂的蒜好	为什么吃烂的蒜好	1
为什么宰相管李泌叫小友	为什么宰相管李泌叫小友	1
为什么用硬笔书写也称书法	为什么用硬笔书写也称法	1
为什么跳蚤有惊人的跳跃本领	原子弹爆炸为什么会产生蘑菇云	0
阿尔瓦德岛为什么叫美人岛	尔瓦德岛为什么叫美人岛	1
为什么孔雀会开屏	为什么孔雀会开屏	1
为什么火箭顶端要安装一根天线样的钢针	为什么说手枪是防身的最好武器	0
为什么月球车能在月球上行驶	为什么变压器能改变电压的高低	0
为什么有些建筑物样子特别怪	为什么有些建物样子特别怪	1
为什么说部首一般都是偏旁，而偏旁不一定是部首	什么是景泰蓝艺术	0
为什么汽车玻璃和家用玻璃不一样	为什么儿童团长王璞能抓住特务	0
为什么对昏迷病人不应背着去医院	水开后摸壶底,烫手吗	0
为什么抑制乙烯的生成和作用，可以贮藏保鲜	为什么抑制乙烯的生成和作用，可以贮藏保鲜	1
为什么天空中的云总是变化，空中的云是从哪儿来的	为什么天空中的云总是变化，空中的云是从哪儿来的	1
为什么游泳时必须用嘴吸气	为什么游泳时必须用嘴吸气	1
为什么有时枪会胀膛炸膛	为什么微光电视可以进行战场监视	0
为什么扁平足对孩子有影响	为什么扁平足对孩子有影响	1
为什么一幅好画不能随意改动	为什么闵子骞受了继母的虐待，却还要原谅她	0
为什么颐和园里的铜牛没有尾巴	为什么颐和里的铜牛没有尾巴	1
为什么说黄鹂是益鸟	为什么他能把小铁球够上来	0
为什么火星看上去是红色的	为什么火星看上去是红色的	1
吃带鱼要去鳞吗	为什么切开的茄子放久了表面发黑	0
为什么通用机枪多为轻重两用	为什么秦始皇要焚书坑儒	0
常吃钙片为什么也会缺钙	体温表为什么采用水银	0
为什么说徐悲鸿是中国美术界的一代宗师	为什么有些磺胺类药要与小苏打合用	0
为什么说黄鹂是益鸟	为什么手枪用布包起来不好	0
新生儿乳房肿大为什么不能挤	为什么大连的贝雕最好	0
为什么要在花盆里放些空蛋壳	为什么成人不要搂着孩子睡觉	0
为什么短命菊是植物中生命最短的	为什么苍蝇停在天花板上不会掉下来	0
什么叫姑娘追	为什么捞来的蝌蚪都变成了癞蛤蟆	0
为什么不要把桔子皮扔掉	为什么不要把桔皮扔掉	1
动物能听懂音乐吗	动物能听懂音乐吗	1
为什么金星表面温度特别高	为什么要提倡说普通话	0
为什么称巴西是足球王国	为什么称巴西是足球王国	1
墙皮为什么会出汗	为什么哈萨克族人喜欢冬不拉	0
语文的含义是什么	语文的含义是什么	1
电流通过人体吗	为什么幼儿学反面角色快	0
为什么叫太阳海岸	为什么叫太阳海岸	1
为什么喝粥能滋补身体	为什么喝粥能滋补身体	1
为什么鱼的身上会有黏液	为什么会有静电	0
为什么要言之有序	新生儿乳房肿大为什么不能挤	0
为什么说我国的国画是国宝	为什么说我国的国画国宝	1
什么是戏曲的唱念做打	为什么子弹在飞行时旋转	0
为什么应该培养随手查字典的习惯	为什么战斗机被称作空中霸王	0
为什么松树会产生松脂	为什么松树会产生松脂	1
为什么娜娜会把幼儿园的积木拿回家	为什么娜娜会把幼儿园的积木拿回家	1
爬云梯的梯子短一些是否更安全	爬云梯的梯子短一些是否更安全	1
斑马身上的花纹有什么用	为什么洗澡时手上会有许多皱纹	0
铅字是光用铅制造的吗	为什么水槽的下水管常做成弯曲的	0
为什么磁卡电话能自动计费	为什么磁卡电话能自动计费	1
做课间操有什么好处	蛇为什么喜欢在春天蜕皮	0
为什么说我国的国画是国宝	为什么说我国的国画是国	1
为什么要提倡说普通话	为什么要提倡说普话	1
什么是褒义词	为什么人要睡觉	0
为什么不让皇帝看起居注	为什么夏天人的皮肤上容易长出小红点	0
为什么赫哲族人爱穿鱼皮衣	为什么赫哲族人爱穿鱼皮衣	1
为什么叫胜棋楼	为什么坦克也能够用于扫雷	0
新生儿乳房肿大为什么不能挤	新生儿乳房肿大为什么不能挤	1
为什么现代通信要利用卫星	为什么现代通信要利用卫星	1
什么是数字电视	么是数字电视	1
为什么手套能表演节目	为什么人会做梦	0
为什么说漳州是水仙之乡	成卷的塑料薄膜展开时为什么会吸引毛发	0
为什么我国是世界上农作物起源最早的国家	为什么要开发组合食品	0
火车汽笛为什么变化?浅谈多普勒效应	为什么毒蛇和无毒蛇长得不一样	0
为什么天空中会出现流星	有关节炎的人能参加剧烈运动吗	0
为什么说西游记是一部浪漫主义杰作	为什么不用纯酒精消毒	0
为什么刚接的自来水盆里有许多气泡	为什么刚接的自来水盆里有许多气泡	1
猪为什么用嘴巴拱泥土	为什么可以利用超声波进行清洗	0
为什么大理石有各种各样的颜色	为什么大理石有种各样的颜色	1
眼镜腿转动不灵怎么办	为什么电子琴能模拟其他乐器的声音	0
为什么海豹喜欢吃石块	为什么成年人吃鱼比吃肉好	0
喇叭为什么变调了	喇叭什么变调了	1
为什么植物间有相亲和相克的关系	为什么冰雹出现在暖季	0
为什么说太阳离我们很远很远	为什么说太阳离我们很远很远	1
!·为什么寒冷的冬天鸟也不怕冷	谢安为什么要批评哥哥	0
为什么星星会发光	为什么星星会发光	1
为什么壁虎的尾巴容易断	为什么肖思话决心改恶从善	0
为什么冬天孩子的手和脸容易皴裂	宇航员在太空中怎样称体重	0
为什么飞机要装红绿灯	什么飞机要装红绿灯	1
为什么彩色胶卷能拍出彩色照片	为什么有的植物间也有冤家对头	0
为什么会产生龙卷风	为什么会产生龙卷风	1
为什么回音壁、三音石会传声	什么回音壁、三音石会传声	1
为什么钢筋混凝土楼板在运输或施工中不可倒放	为什么钢筋混凝土楼板在运输或施工中不可倒放	1
什么是贫铀弹	为什么能利用卫星进行军事侦察	0
为什么孩子会得肠虫病	汽油的90#、93#、97#是什么意思	0
为什么有些蚊虫不怕杀虫剂	为什么有些蚊虫不怕杀虫剂	1
为什么鸟的歌声特别婉转动听	为什么计算机能思考	0
为什么不要空腹喝牛奶	为什么赵高要指鹿为马	0
为什么要纠正错别字	为什么纠正错别字	1
为什么早晨和傍晚的太阳比中午的太阳大	为什么易拉罐能变成小工艺品	0
为什么哈萨克族姑娘的帽顶上插着猫头鹰羽毛	为什么萨克族姑娘的帽顶上插着猫头鹰羽毛	1
为什么达斡尔族人爱往脸上抹黑	为什么东西扔上去总会落下来	0
人为什么会长头发	为什么说太阳是太阳系的家长	0
什么叫姑娘追	为什么在家里就可以网上购物	0
反装备武器有哪些	为什么青铜宝剑不会生锈	0
为什么海水无色而大海蓝色	为什么瑞士被称为钟表王国	0
为什么人在打呵欠时会眼泪汪汪	为什么昆虫没有鼻子却嗅觉灵敏	0
为什么石灰岩洞中会生长着石笋和钟乳石	为什么对昏迷病人不应背着去医院	0
为什么鸟有三个眼睑	为什么要学习汉语拼音	0
为什么给鸡戴红色眼镜可以多产蛋	为什么给鸡戴红色眼镜可以多产蛋	1
海牛是一种什么动物	海牛是一种什么动物	1
为什么小熊猫总长不大	为什么小熊猫总长不大	1
为什么经常参加锻炼能使胖人消瘦，能使瘦弱的人变得壮实	磁通量不改变也会产生感应电流吗	0
为什么杂技演员表演水流星时，水不会洒出来	为什么要过中秋节	0
为什么有些贝类喜欢生活在石头里	世界上有多少种昆虫	0
为什么三脚架重机枪的火线越高射弹散布面积越大	为什么脚架重机枪的火线越高射弹散布面积越大	1
蒲松龄为什么能写出聊斋志异	羊多利是怎样被制造出来的	0
老虎洞中为什么没有老虎	老虎洞中为么没有老虎	1
为什么要给小草记功劳	德昂族有哪些礼仪及禁忌	0
为什么嗅觉有时会失灵	为什么植物生长离不开氮肥	0
为什么边尔村的泉被称为神泉	为什么边尔村的泉被称为神	1
为什么大熊猫是国宝	为什么临碑帖对提高书法水平能起很大作用	0
刚出锅的鸡蛋为什么不烫手	鄂温克族是怎样过米阔鲁节的	0
为什么说宇宙有限而无边	为什么说宇宙有限无边	1
为什么先看到闪电后听到雷声	为什么先到闪电后听到雷声	1
猫为什会埋大便	为什会埋大便	1
夜晚的天空为什么是黑的	为什么流星会从天上掉下来	0
地球为什么会自转	地球什么会自转	1
为什么冬季夜空中的星星比夏季少	为什么计算机又称电脑	0
为什么把唐代上釉的陶器被称做唐三彩	为什么把唐代上釉的陶器被称做唐三彩	1
水滴落沸油中会怎样	为什么燃烧的蜡烛有时会冒黑烟	0
人是怎样消化食物的	为什么天上的星星有时多，有时少	0
水杉是名副其实的世界爷吗	胖人下滑的速度会比瘦人更快吗	0
近视眼患者为什么要戴眼镜	近视眼患者为什么要戴眼	1
为什么要坚持写片断	为什么红豆又叫相思豆	0
宇宙是什么样子	宇宙是什么样	1
为什么花盆底部有个小洞	为什么叫民歌	0
为什么海带不会开花结籽也能繁殖	为什么有的人会花粉过敏	0
为什么说墨不一定是黑的	为什么计算机能思考	0
为什么猪流感让人闻之色变	为什么猪流感让人闻之色变	1
冬季为什么用湿手接触铁器时会被粘住	经常吃生鸡蛋的人为什么会使头发早白	0
什么是戏曲的唱念做打	太阳还能使地球上的生命维持多久	0
为什么鱼在冰冷的水里不怕冷	为什么鸟飞行时要把两腿藏在身下	0
为什么同样的植物有的长得高，有的长得矮	为什么同样的植物有的长得高，有的长得矮	1
为什么常常把树干刷成白色	昆虫是怎样保护自己的	0
为什么早餐很重要	为什么餐很重要	1
晚香玉为什么夜来香	为什么不让踩草坪	0
为什么说数学起源于结绳计数和土地丈量	为什么小草帽风铃很漂亮	0
为什么昆虫会蜕皮	为什么把从我国到古罗马国的路称作丝绸之路	0
为什么胡杨能在沙漠中生存	鱼为什么比肉容易坏	0
为什么要用互联网	为什么要用互联	1
为什么白天能看见太阳，晚上看不见太阳	为什么白天能看见太阳，晚上看见太阳	1
为什么激光枪能百发百中	CT能检查什么病	0
怎样用树叶制书签	为什么陈继要钻进苇丛里	0
剥切葱时为什么会流泪	剥切葱时为什么会流	1
什么是褒义词	为什么孙子兵法被誉为 兵学鼻祖 	0
什么是对牛弹琴和对马弹琴	人造卫星为什么会飞出地球	0
水族为什么要过端节	为什么淳于意流着眼泪，夸赞自己的女儿	0
为什么武则天会留下无字碑	为什么武则天会留下无字	1
体温表为什么采用水银	黑白电视机为什么能收看彩色电视节目	0
为什么金星最亮	为什么金星最亮	1
为什么要提倡少年儿童多写自己的生活和心灵世界	为什么要提倡少年儿童多写自己的生活和心灵世界	1
你好吗	常规潜艇为什么不能长时间在水下	0
为什么雪莲花不畏冰雪高寒	为什么意大利被称为旅游之国	0
为什么门镜又被称作警眼	为什么门又被称作警眼	1
为什么血能在人体中流动	为什么幼儿常常爱告状	0
为什么冬天窗玻璃上有冰花	为什么冬天窗玻璃上有冰花	1
为什么游泳时必须用嘴吸气	为什么冬天孩子的手和脸容易皴裂	0
为什么白薯叶子会结薯	为什么侗族人管程阳桥叫做风雨桥	0
为什么不能吃死鳝鱼	为什么家里常准备点白矾	0
为什么叶子两面的颜色深浅不同	为什么工艺美术深受幼儿园小朋友的喜爱	0
胆的大小与胆量有关系吗	大豆为什么被称为豆中之王	0
为什么要给孩子打预防针	为什么会有双胞胎	0
你知道普米族人的礼仪和禁忌吗	为什么我国是世界上最早栽培菊花的国家	0
为什么最早的火箭是中国发明的	为什么只有企鹅能在南极安家	0
为什么摄像机摄像时不需要对焦和曝光	为什么有两个西湖	0
什么是空地导弹	什是空地导弹	1
黑白电视机为什么能收看彩色电视节目	为什么说喜马拉雅山是从海里升起来的	0
为什么子女与父母之间会产生代沟	为什么子女与父母间会产生代沟	1
为什么计算机会产生千年虫问题	为什计算机会产生千年虫问题	1
为什么说海洋和陆地是会变化的	为什么天上会出现新星	0
如何打开锈锁	如何打开锁	1
雾是怎样形成的	为什么网络有局域网、城域网和广域网之分	0
为什么叫姐妹山	为什么叫姐山	1
为什么人有脉博	什么人有脉博	1
什么叫电子点火器	么叫电子点火器	1
为什么血是红色的	为什么血是红色的	1
乐山大佛是怎样建成的	乐大佛是怎样建成的	1
影碟上常见镭射，究竟镭在哪儿，会损害人体吗	影碟上常见镭射，究竟镭在哪儿，会损害人体吗	1
为什么有时候蜻蜓飞得很低	怎样更准确地审清题意	0
为什么熟鸡蛋能竖立旋转	为什么熟鸡蛋能竖立旋转	1
什么是超声显微镜	为什么看不见香蕉果实里面的种子	0
为什么贝类身上要长壳	为什么贝类身上长壳	1
为什么奥运会以五色环为标志	为什么奥运会以五色环为标	1
为什么合理的膳食应当荤素搭配	为什么说画鬼容易画犬难	0
为什么廷廷认不出那只泥猫了	为什么廷廷认不出那只泥猫了	1
怎样用比较的方法审题	傣族有哪些礼仪和禁忌	0
海水为什么是咸的	拔牙后为什么要及时镶牙	0
人为什么会打嗝	人为么会打嗝	1
为什么叫马跑泉	工艺美术为什么会包括许许多多的内容	0
为什么鸸鹋又叫长跑健将	为什么萌萌拆半导体	0
为什么玲玲和鞋说话	为什么玲玲和鞋说	1
为什么他们能走过水坑	为什么他们能走过坑	1
为什么铁特别容易生锈	为什么美术又叫造型艺术	0
为什么晚上捕鱼用灯能引诱鱼群	为什么晚上捕鱼用能引诱鱼群	1
神舟号飞船为什么选在冬季发射	为什么王祥吃东西，王览总要先尝一口	0
为什么用海水洗衣服时不能用肥皂	为什么用海水洗衣服时不能用肥皂	1
无声手枪为什么会无声	无声手枪为什么会无声	1
为什么冬天会有霜	为什么阴天湖水会冒泡、变浑	0
斑马身上的花纹有什么用	大豆为什么被称为豆中之王	0
扬州八怪怪在何处	扬州八怪怪何处	1
为什么蚯蚓截成两半还能活	为什么临碑帖对提高书法水平能起很大作用	0
为什么华山以险闻名	为什么韩德常老师是幼儿音乐教育家!·和幼儿作曲家	0
冷水和热水哪个沸腾快	为什么幼儿常常会破涕为笑	0
为什么蚌长期闭着壳不会被饿死	为什么蚌长期闭着壳不会被饿死	1
为什么彩虹的七色顺序总是不变	为什么狗在热天爱伸出舌头	0
湿袜子为什么粘脚	为什么黄鳝小时候是雌性，长大了却是雄性	0
人们为什么喜欢到盘山游览	昆虫是怎样保护自己的	0
为什么抑制乙烯的生成和作用，可以贮藏保鲜	为什么抑制乙烯的生成和作用，可以贮藏保鲜	1
为什么金沙江畔会有醉汉林	为什么有时太阳周围会出现彩色光圈	0
什么是宽带	为什么毒蛇和无毒蛇长得不一样	0
为什么说单纯学习技法并不能真正学好美术	为什么说单纯学习法并不能真正学好美术	1
为什么土家族要给大公鸡献花	为什么植物有酸、甜、苦、辣的味道	0
为什么说中国的书法和绘画是一对兄弟	为什么说中国的书法和绘是一对兄弟	1
密度计的刻度为什么是不均匀的	卓别林为什么能成为喜剧大师	0
为什么米芾的字写得那样好	脾气和脾有关吗	0
为什么在地球上看到的星星是黄色的	为什么会爆发第二次世界大战	0
什么是舰载机	什么是舰载机	1
为什么大理石有各种各样的颜色	佛手瓜的种子为什么不能与瓜分开	0
为什么纸盒做的小火车能拐弯	人是怎样发声的	0
黑色和白色也是配不出来的颜色，为什么不叫原色呢	黑色和白色也是配不出来的颜色，为什么不叫原色呢	1
哈哈镜照人为什么会变样	哈哈镜照人为什么变样	1
为什么北极熊不怕冷	为什么巨杉是 世界巨木之首	0
毛莱是哪个民族的传统体育项目	为什么花有大小美丑之分	0
为什么要在花盆里放些空蛋壳	为什么泥鳅要吐泡	0
人为什么想不开	为什么青少年要预防肥胖	0
为什么海边的白天和黑夜温度变化不大呢	为什么怪石被称为大象石	0
为什么天空是蓝色的	为什么水上飞机能在海上起降	0
为什么丁丁知道排队了	为什么丁丁知道排队	1
为什么楼梯的台阶边缘有棱	为什么它是世界上最小的鸟	0
为什么军事上的核时代即将过去	为什么吃东西要细嚼慢咽	0
为什么他们争着让水桶离自己近一点	为什么互联网上要设立防火墙	0
什么是空空导弹	什么是空空导弹	1
油画为什么要用油来调颜色	油画为什么要油来调颜色	1
为什么冬天暖房要开窗子	为什么天暖房要开窗子	1
为什么重阳节要登高	为什么重阳节要登高	1
为什么水槽的下水管常做成弯曲的	为什么植物的种子能无脚走遍天下	0
什么是弹道导弹	植物怎样抵御动物的侵害	0
你知道人声有哪些类别吗	什么叫电子点火器	0
为什么工厂的烟囱要盖得很高很高	为什么大连的贝雕最好	0
为什么藕有许多小洞洞	为什么管金丝猴叫精灵鬼	0
为什么丁丁知道排队了	为什丁丁知道排队了	1
两个相同的塑料袋，一个折起来，一个装满空气，哪个重	两个相同的塑料袋，一个折起来一个装满空气，哪个重	1
为什么鱼要有鱼鳔	为什么广州也叫羊城	0
为什么B超能诊断疾病	为什么B超诊断疾病	1
为什么吃饭前后不要做剧烈活动	为什么听自己录音会觉得声音变了	0
为什么晚上捕鱼用灯能引诱鱼群	为什么藏族人民家家都养牦牛	0
为什么数星星的孩子能成为天文学家	为什么数星星的孩子能成为天文学	1
地球为什么会自转	为什么孩子喝水要选择时间	0
为什么不宜长久呆在空调房间里	为什么不宜长久呆在空调房间里	1
为什么蜗牛爬行时会留下足迹	为什么蜗牛爬行时会留下迹	1
为什么闵子骞受了继母的虐待，却还要原谅她	为什么小朋友的心脏跳动比成人快	0
为什么日食发生在初一而不是十五	树叶为什么落下来	0
为什么幼儿教育小学化的方式会降低幼儿大脑功能	为什么幼儿教育小学化的方式会降低幼儿大脑功能	1
世界火炉指的是哪里	什么是猎潜艇	0
为什么嗅觉有时会失灵	为什么小熊猫总长不大	0
为什么戴胜鸟又叫臭姑鸪	为什么有的表要上弦才走，有的表不上弦也走	0
什么是褒义词	什么是义词	1
为什么哈萨克族人要向客人献羊头	什么树比钢还硬	0
扬州八怪怪在何处	为什么白天看不见星星	0
为什么头发会脱落	为什么皮肤晒黑是正常现象	0
为什么夏天人的皮肤上容易长出小红点	为什么说她是聪明的小姑娘	0
为什么不能用果汁服药	为什么子女与父母之间会产生代沟	0
为什么必需血型相同才能输血	为什么合理的膳食应当荤素搭配	0
树叶为什么落下来	树叶为什么落来	1
为什么阴天时看不见太阳	为什么阴天时看不太阳	1
为什么激光武器有很强的杀伤力	为什么激光武器有强的杀伤力	1
为什么航空母舰能潜到水下航行	为什么航空母舰能潜到水下航行	1
唱歌跑调与情绪有关吗	为什么手枪用布包起来不好	0
为什么说缝叶莺是灵巧的缝纫女	为什么说缝叶莺是灵巧的缝纫女	1
为什么熟鸡蛋能竖立旋转	在文章中怎样使用人称	0
单腿怎么立不住	为什么磁卡电话能自动计费	0
为什么葡萄干里没有核	为什么葡萄干里没有	1
为什么有的孩子总是吃手或咬指甲	为什么有的孩子总是吃手或咬指甲	1
为什么这盆小菊花格外好看	为什么说要用心去观察	0
为什么上党人参会失踪	为什么上党人参会失踪	1
海鸥为什么总追着轮船飞	鸥为什么总追着轮船飞	1
为什么红海的海水是红色的	为什么不能用生豆油拌馅	0
敌人为什么要杀害罗志群和邓金娣	敌人为什么要杀害罗志和邓金娣	1
为什么太监要往蜜坛子里放老鼠屎	为什太监要往蜜坛子里放老鼠屎	1
为什么韩愈买来一根蜡烛	初学画画的人为什么最好先画水粉画	0
为什么游泳时必须用嘴吸气	为什么游泳时必须用嘴吸气	1
为什么满族人院里都立着一根木杆	为什么生活在贝壳里的动物叫软体动物	0
为什么会出现开元盛世	为什么会出现开元盛世	1
为什么弟弟说苹果酸，姐姐说苹果甜	为什么弟弟说苹果，姐姐说苹果甜	1
为什么说黑枣不是枣	为什么同一个玉米棒上会有不同颜色的粒	0
为什么大禹能够治水成功	为什么电冰箱在停机后不能立刻起动	0
为什么植物离不开空气	为什么可乐瓶变成了可乐猪	0
纸是怎样生产出来的	是怎样生产出来的	1
为什么会出现开元盛世	为什么会出开元盛世	1
吃带鱼要去鳞吗	吃带鱼要去鳞吗	1
为什么面对幼儿做示范动作时应镜面示范	为什么面对幼儿做示范动作时应镜面示范	1
为什么蟋蟀会用翅膀唱歌	为什么蟋蟀会用翅膀唱	1
为什么有的植物能连生在一起	为什么有的植物能连生在起	1
有些坦克炮的抽烟装置为什么偏置	什么是潜艇	0
为什么会发生地震	为什么飞镖的尖鼻子先落地	0
为什么用薰衣草来薰衣服特别香	为什么螺是建筑奇才	0
为什么用瓶盖做成的小乐器声音很好听	为什么门巴族人都喜欢用木碗	0
为什么冬季夜空中的星星比夏季少	为什么把足球称为世界第一运动	0
小孩为什么要唱儿童歌曲不要唱大人歌曲	孩为什么要唱儿童歌曲不要唱大人歌曲	1
为什么水星上没有大气层	人造卫星为什么会飞出地球	0
为什么耳朵最怕冷	为什么午睡前要散步	0
为什么说甲骨文是中国最早的书法艺术	为什么蚂蟥具有医学用途	0
为什么有的人唱歌跑调	为什么让硕硕当小炊事员，他才高兴剥豆豆	0
为什么小手指变成了大拇哥	为什么半可燃药筒能被广泛应用	0
为什么弹壳底火被击针一击即发火	为什么弹壳底火被击针击即发火	1
为什么高压电缆的绝缘子是一节节的	蒲松龄为什么能写出聊斋志异	0
火车头能做得轻便些吗	为什么李世民会发动玄武门之变	0
什么是脉冲星	为什么传说天上有十个太阳	0
为什么苹果皮上会有黑褐色干皮	为什么苹果上会有黑褐色干皮	1
为什么阿昌族人喜欢户撒刀	为什么阿昌族人喜欢户撒刀	1
带沙袋进行体育锻炼会得关节炎吗	为什么海豹不睡大觉	0
为什么北京人爱看曲艺	秋天为什么大雁往南飞	0
布依族的六月六、四月八是怎么回事	人在真空中会怎样	0
为什么小调皮进入了角色	火星上有生命吗	0
为什么小熊猫总长不大	为什么月亮有时大，有时小，有时明，有时暗	0
雨是怎样形成的	为什么他能用手指分辨出糖、盐、碱	0
为什么咖啡能提神醒脑	为什么咖啡能提神醒脑	1
为什么运动时应有意识地使呼吸变得深长和缓慢	初学画画的人为什么最好先画水粉画	0
为什么这盆小菊花格外好看	干冰所产生的白雾是什么东西	0
为什么不是一个月看到一次日、月食	为什么不是一个月看到一次日、月食	1
雷达是怎样探测目标的	雷达是怎样探测目标的	1
什么是和平号空间站	为什么头发会脱落	0
荆轲为什么要刺杀秦王	荆轲为什么要刺杀秦王	1
为什么潜艇里的人在水下不会憋死	为什么长吻鱼喜欢接吻	0
植物为什么可以帮助人们寻找矿藏	植为什么可以帮助人们寻找矿藏	1
为什么豆类食品有益健康	怎样使笔尖好用	0
为什么被蜘蛛吃过的小虫子会剩下空壳	潜水艇为什么能上浮和下沉	0
为什么冬天窗玻璃上有冰花	为什么冬天窗玻璃上有冰花	1
为什么自行车比赛选手要走之字形路线	为什么自行车比赛选手要走之字形线	1
为什么曹刿能够战胜强大的齐军	为什么竹子开花后会死	0
什么是贫铀弹	鲁迅为什么要塑造阿Q这个人的形象	0
为什么不能拿大伙儿的东西	为么不能拿大伙儿的东西	1
怀孕后为什么要少吃米饭	为什么天上的星星有的亮、有的暗	0
为什么会有海上草原、海底森林	为什么地球上三极臭氧层破坏严重	0
你知道普米族人的礼仪和禁忌吗	你知道普米族人的礼仪和禁忌吗	1
飞机为什么能飞	飞为什么能飞	1
为什么要照顾年龄小的伙伴儿	为什么有的音乐叫激光音乐	0
为什么冰山被称为海洋杀手	为什么长跑时呼吸节奏很重要	0
为什么运动时应有意识地使呼吸变得深长和缓慢	大雪后为什么很寂静	0
为什么做眼保健操能预防近视	佤族有哪些礼仪和禁忌	0
有的沿海岛屿降水为什么比邻近大陆还少	有的沿海岛屿降水为什么比邻近大陆还少	1
为什么孟母三次搬家	为什么长跑时呼吸节奏很重要	0
为什么八月十五吃月饼	为什么说商纣王是著名的大暴君	0
为什么犀牛鸟能和凶猛的大犀牛成为好朋友	为什么打野战要穿迷彩服	0
为什么光可窃听	为什么叫做莫干山	0
为什么B超能诊断疾病	为什么葡萄牙人与西班牙人斗牛各不相同	0
为什么楼房外边的墙上要安装管子	彗星会撞上地球吗	0
为什么向日葵的花总是朝着太阳	为什么向日葵的花总是朝着太阳	1
为什么鱼的身上会有黏液	为什么鱼的身上会有黏	1
为什么称这棵连株榕树为最大的榕树	为什么热水瓶能保温	0
为什么蛇能在黑夜里捕捉到田鼠	苗族有哪些礼仪及禁忌	0
为什么演员跳踢踏舞时脚下会发出很响的声音	为什么萧遥欣要劝朋友爱护鸟	0
无线电波能在水下传播吗	给电池充电先要放掉剩余的电，对吗	0
为什么马拉松长跑的距离规定为42195米	为什么不能滥用抗生素	0
为什么小佳佳会盛气凌人	为什么小佳佳会盛气凌人	1
为什么不要空腹喝牛奶	为什么不要空腹喝牛奶	1
为什么有的坦克能在陆地和水中行使	为什么荆轲刺秦王没有成功	0
为什么把有的乐队叫交响乐队	为什么东北虎的毛色要比华南虎艳丽	0
什么是外来词	唐宋散文八大家指哪些人	0
为什么砚是文房四宝中的一宝	隐形飞机为什么能隐形	0
为什么狗认识路	为什么狗认路	1
为什么肉汤凉得较开水慢	为什么肉汤凉得较开水慢	1
画中国画的纸为什么同画其他画的纸不一样	为什么说音乐能寓教于乐	0
为什么有些建筑物样子特别怪	为什么吃生鸡蛋不好	0
在文章中怎样使用人称	在文章中怎样用人称	1
你知道人声有哪些类别吗	为什么要给星星取名字	0
为什么水槽的下水管常做成弯曲的	为什么糖尿病患者要护脚	0
为什么摄像机摄像时不需要对焦和曝光	为什么摄像机摄像时不需要对焦和曝光	1
为什么说植物的种子是大力士	为什么有的墙用空心砖来砌	0
海水会越来越咸吗	为什么叫马跑泉	0
为什么李崇将孩子判给苟泰	为什么李崇将孩子判给泰	1
为什么红灯停，绿灯行	为什么红灯停，绿灯	1
体温表为什么采用水银	为什么海水是咸的	0
为什么说西游记是一部浪漫主义杰作	为什么说西游记是一部浪漫主义作	1
胖人下滑的速度会比瘦人更快吗	为什么会发生海啸	0
为什么液晶能显像	为什么人会有冷和热的感觉	0
为什么未来的导弹会有思维能力	为什么未来的导弹会有思维能力	1
什么是发射窗口和发射场	为什么说我国是世界上盐湖最多的国家	0
唐宋散文八大家指哪些人	为什么聪明的贝贝不会区分各种几何图形	0
为什么岳柱对名画提出批评	为么岳柱对名画提出批评	1
为什么电冰箱在停机后不能立刻起动	为什么电冰箱在停机后不能刻起动	1
为什么有的鱼离开水不会死	怎样用可乐瓶做小姑娘的裙子	0
笔杆上的小孔有什么功用	如果人们能够进入贯穿地球的隧道中，将发生什么事情	0
为什么董仲舒要提出罢黜百家，独尊儒术	为什么董舒要提出罢黜百家，独尊儒术	1
塔塔尔族和京族的传统节日是什么	为什么水滴能在荷叶上滚来滚去	0
为什么独龙族人都吃大锅饭	纸是怎样生产出来的	0
纸是怎样生产出来的	纸是怎样生产出来的	1
为什么不要边看书报边吃饭	为什么不要边看书报边吃饭	1
为什么吃捣烂的蒜好	炒栗子的糖砂有什么功用	0
为什么摄像机摄像时不需要对焦和曝光	为什么摄像机摄像时不需要对焦和曝光	1
为什么深海里的鱼会发光	为什么孩子要多吃点含钙食品	0
火箭升空的瞬间，地面升起的庞大白色气团是什么东西	为什么细嫩的幼苗能拱动石板	0
为什么比赛前要检测兴奋剂	为什么比前要检测兴奋剂	1
人为什么想不开	八哥在水牛背上啄什么	0
为什么有些建筑物样子特别怪	为什么有些建筑物样子特别怪	1
为什么每天锻炼也消耗不完人的体力	为什么张汤让驴主人两天内不要喂驴	0
为什么曹刿能够战胜强大的齐军	为什么碰伤的皮肤处会有乌青块	0
为什么蛇能在黑夜里捕捉到田鼠	为什么蛇能在黑夜里捕捉到田鼠	1
你能让铅笔尖向下直立在手指上吗	你会打秋千吗	0
什么是对牛弹琴和对马弹琴	什么是对牛弹琴和对弹琴	1
为什么吃饭时看书不好	为什么计算机又称电脑	0
为什么天上的星星数不清	为什么不要随手扔掉可乐瓶	0
为什么小朋友要助人为乐	为什么小朋友要助人为乐	1
影碟上常见镭射，究竟镭在哪儿，会损害人体吗	影碟上常见镭射，究竟镭在哪儿，会害人体吗	1
畲族有什么礼仪及禁忌	为什么无声手枪是无声的	0
为什么巨杉是 世界巨木之首	为什么宝石是五颜六色的	0
为什么要照顾年龄小的伙伴儿	为什么要照顾年龄小的伙伴儿	1
宇宙中物质是从哪里来宇宙外面又是什么	为什么肥皂能洗掉脏东西	0
为什么他俩不去评理了	热是什么	0
为什么独龙族人都吃大锅饭	飞机里新鲜空气哪里来	0
为什么天空会呈现不同的颜色	为什么天空会呈现不同的颜色	1
什么是小舌	为什么张九龄用鸽子送信	0
为什么植物的根向下生长，茎向上生长	为什么植物的根向下生长，茎向上生长	1
为什么说蚂蚁可以用来治病	为什么南非被称为黄金之乡	0
为什么极光出现在地球两极	什么极光出现在地球两极	1
为什么把台北的热水湖称作酸湖	为什么把台北热水湖称作酸湖	1
为什么幼儿会出现不是自己错也承认错的现象	为什么幼儿会出现不是自己错也承认错的现象	1
为什么白天看不见星星	为什么郡守连连夸赞李远像个大将军	0
为什么会发生海啸	为什么会发生海啸	1
为什么红海的海水是红色的	什么红海的海水是红色的	1
为什么说晨晨最勇敢	大蒜为什么能抑菌	0
为什么娜娜会把幼儿园的积木拿回家	为什么看林人是森林纵火犯	0
为什么叫摇篮曲	为什么叫摇篮曲	1
为什么会形成东非大裂谷	为什么会出现一屋跨两国的情况	0
为什么买不到活的海水鱼	为什么有时太阳周围会出现彩色光圈	0
为什么小孩不能吃补品补药	为什么狗能吃硬骨头	0
为什么陈继要钻进苇丛里	为什么继要钻进苇丛里	1
什么是侗族芦笙舞	为什么张汤让驴主人两天内不要喂驴	0
为什么要开除冥王星	为什么狗睡觉时把嘴藏在前肢下	0
为什么用扇子扇炉火越扇越旺，而扇蜡烛却一扇就灭	为什么用扇子扇炉火越扇越旺，而扇蜡烛却一扇就灭	1
为什么花有大小美丑之分	为什么传说天上有条银河	0
怎样辨别名词、动词和形容词	为什么他们能顺利通过独木桥	0
除夕夜为什么家家户户要吃团圆饭	为什么要学习格言	0
为什么雪莲花不畏冰雪高寒	为什么雪莲花不畏冰雪高寒	1
为什么青少年不宜经常开夜车	海水为什么是蓝色的	0
你好吗	日本庆祝男孩节为什么要挂鲤帜	0
歌曲二字的含义是什么	为什么狗的嗅觉特别灵敏	0
为什么焰火会有不一样的颜色	为什么物体的重量会变	0
号称绿色陷阱的沼泽是怎样形成的	为什么大雁要排成一字或人字形队伍飞行	0
为什么伤口碰到咸的东西会特别痛	为什么说应该提倡幼儿双手并用	0
为什么同一个玉米棒上会有不同颜色的粒	中国画为什么有工笔画和写意画之分	0
为什么望远镜能使我们看清远处的东西	为么望远镜能使我们看清远处的东西	1
为什么小伙计能成为大画家	为什么说地球里面不是厚厚的土	0
为什么计算机病毒武器比核武器更厉害	什么计算机病毒武器比核武器更厉害	1
为什么火箭炮能够布雷	为什么计算机的时钟在断电时仍能正常工作	0
月亮上是什么样的	为什么星星会发光	0
蚊子爱叮咬哪些人	蚊子叮咬哪些人	1
狐为什么会给人留下诡计多端的印象	狐为什么会给人留下诡计多端的印象	1
为什么用扇子扇炉火越扇越旺，而扇蜡烛却一扇就灭	为什么用扇子扇炉火越扇越旺，而扇蜡烛却一扇就灭	1
为什么学画素描会遇到很多怪词	为什么学画素描会遇到很多怪词	1
为什么禁放烟花爆竹	清明节为什么是我国的传统节日	0
为什么薄薄的圆纸片能立起来	为什么东西扔上去总会落下来	0
魔鬼谷里的草为什么茂盛	魔鬼谷的草为什么茂盛	1
为什么月亮朝着地球那一面是不变的	为什么月亮朝着地球那一面是不变的	1
为什么早餐很重要	为什早餐很重要	1
什么是弹道导弹	为什么不能吃死鳝鱼	0
为什么台风的风眼中没有风	为什么台风的风眼中没有风	1
为什么毒蛇和无毒蛇长得不一样	为什么毒蛇和无毒蛇长得不一样	1
为什么兔子的耳朵很长	为什兔子的耳朵很长	1
为什么蛤、蚌里能产珍珠	什么蛤、蚌里能产珍珠	1
为什么临碑帖对提高书法水平能起很大作用	为什么临碑帖对提高书法水平能起很大作用	1
为什么触摸屏能对人的触摸作出反应	为什么小朋友的心脏跳动比成人快	0
为什么小熊猫总长不大	什么是贬义词	0
为什么不是一个月看到一次日、月食	为什么不是一个月看到次日、月食	1
为什么有的孩子总是吃手或咬指甲	为什么有孩子总是吃手或咬指甲	1
为什么鱼有鳞片	为什么鱼有鳞片	1
为什么要使用不同的谱号	为什么云有不同的颜色	0
为什么叫做莫干山	为什么叫莫干山	1
为什么人会有冷和热的感觉	为什么要用互联网	0
为什么树叶在天冷的时候会掉下来	为什么树叶在天冷的时候会下来	1
甘遂为什么开绿花	为什么子女与父母之间会产生代沟	0
为什么小熊猫总长不大	为什么小熊猫总不大	1
为什么徐光启要把棉株尖顶上的嫩芽掐断	为什么幼儿对童话故事和童话剧特别感兴趣	0
为什么有的植物能连生在一起	为什么狼的眼睛会闪闪发光	0
为什么海龟和乌龟不一样	为什么吃豆腐最好配点海带	0
同样的粘沙土为什么能烧成不同的砖	贝加尔湖口为什么会立有一块大圆石	0
为什么说秦始皇是中国第一个皇帝	为什么拖拉机的前后轮子不一样大	0
为什么茜茜没举手	眼镜腿转动不灵怎么办	0
为什么郭翻受到大家的敬重	为什么郭翻受到大家的敬重	1
为什么说雕刻和雕塑不一样	为什么说雕刻和雕塑不一样	1
为什么火箭和飞机的头部是尖的	为什么碳钟可以测定古文物的年龄	0
为什么受伤的水果会变黑	景颇族有什么礼仪及禁忌	0
为什么毛南族人喜欢毛南三宝	为什么雅鲁藏布江谷地有地热资源	0
为什么要纠正错别字	什么是太阳风	0
为什么萌萌拆半导体	常规潜艇为什么不能长时间在水下	0
大炮能把卫星送上天吗	麦奇里湖为什么是世界上的一个奇迹	0
新生儿乳房肿大为什么不能挤	新生儿乳房肿大为什么不能挤	1
为什么幼儿往往用错一些有关时间的语词	为什么看不见香蕉果实里面的种子	0
为什么长吻鱼喜欢接吻	为什么太阳照的地方，小朋友会感到暖和	0
成卷的塑料薄膜展开时为什么会吸引毛发	成卷的塑料薄膜展开时为么会吸引毛发	1
星系会互相吞并吗	人是怎样消化食物的	0
为什么三瓣石那么神秘	为什么收音机在晚上收台比白天多	0
为什么轰炸机被称做天空杀手	为什么海龟能认识回故乡的路	0
人们六次登上月球在那里都发现了什么	人们六次登上月球在那里发现了什么	1
为什么长白山是我国产人参最多的地方	为什么长白山是我国产人参最多的地方	1
影碟上常见镭射，究竟镭在哪儿，会损害人体吗	影碟上常见镭射，究竟镭在哪儿，会损害人体	1
怎样旋开玻璃瓶上太紧的铁盖	怎样旋开玻璃瓶上太紧的铁盖	1
为什么反坦克地雷是坦克的克星	为什么丹丹画的长颈鹿脖子比五层楼还高	0
为什么春节要敲锣打鼓放鞭炮	为什春节要敲锣打鼓放鞭炮	1
为什么幼儿不会听反话	为什么周扒皮家的鸡半夜就叫	0
为什么王育要卖身赔羊	什么王育要卖身赔羊	1
为什么鱼缸里的水草会冒泡	为什么鱼缸里的水草会冒泡	1
为什么空气并不空	为什么金刚石最坚硬	0
为什么跳蚤有惊人的跳跃本领	油画为什么要用油来调颜色	0
为什么禹凡突然不愿来幼儿园	鲁迅为什么要塑造阿Q这个人的形象	0
为什么毛笔要用动物身上的毛来做	为什么看不见香蕉果实里面的种子	0
为什么已受外力作用的地雷应就地销毁	为什么已受外力作用的地雷应就地销毁	1
为什么用x表示未知数	为什么用x表示未知数	1
眼镜腿转动不灵怎么办	为什么嗅觉有时会失灵	0
什么是绿色冰箱	什么是绿色冰箱	1
为什么要建国际空间站	为什么布依族人喜欢用鸭头鸭脚待客	0
宝宝为什么总流口水	宝宝为什么流口水	1
为什么老奶奶要磨铁棒槌	为什么老奶奶要磨铁棒槌	1
为什么王育要卖身赔羊	为什么王育要卖身赔羊	1
为什么地球上有那么多山	为什么幼儿经常自言自语	0
成卷的塑料薄膜展开时为什么会吸引毛发	成卷的塑料薄膜展开时为什么会吸引毛	1
为什么月球总是以固定的一面对着地球	为什么隐形飞机也会有克星	0
反装备武器有哪些	湖泊是怎样形成的	0
为什么春天会飞出许多白毛毛	为什么春天会飞出许多白毛毛	1
为什么会发生泥石流	什么是发射窗口和发射场	0
为什么莎莎唱歌喜欢用小沙锤来伴奏	为什么小朋友容易被烫伤	0
为什么仡佬族人要给牛过生日	为什么仡佬族人要给牛过日	1
什么是冲锋枪	为什么叫做莫干山	0
为什么变压器能改变电压的高低	为什么变压器能变电压的高低	1
什么是黑洞	什么是黑洞	1
你了解气门芯吗	为什么少年长白发	0
为什么有的海洋会发光	有的沿海岛屿降水为什么比邻近大陆还少	0
香蕉果实里有种子吗	香蕉果实里有种吗	1
圣克劳德为什么叫做烟斗之城	为什么花也要睡觉	0
什么是猎潜艇	为什么说大脑是人体的指挥中心	0
为什么把花的叶子摘了，花就死了	为什么吃捣烂的蒜好	0
为什么说树叶是最简易的吹奏乐器	为什么对昏迷病人不应背着去医院	0
为什么要理发	静电复印机是怎样工作的	0
论语是孔子写的吗	为什么植物要长很长的根	0
为什么计算机会产生千年虫问题	为什么严寒的南北极也有植物安家落户	0
为什么运动时应有意识地使呼吸变得深长和缓慢	为什么运动时应有意识地使呼吸变得深长和缓慢	1
植物为什么也需要睡大觉	植物为什么也需要睡大觉	1
为什么桥都设计成凸形的	人为什么感觉到冷	0
为什么肠炎、痢疾常在夏秋季发生	为什么满族人院里都立着一根木杆	0
动物为什么不会迷失方向	动物什么不会迷失方向	1
为什么达斡尔族人爱往脸上抹黑	人为什么要经常眨眼	0
蚂蚁从高处落下为什么摔不死	为什么耶路撒冷被称为圣城	0
怎样保存腻子	怎样保存子	1
为什么曹冲能知道大象的重量	为什么曹冲能知道大象的重量	1
怎样使用互联网	怎样使用互联网	1
月全食的时候为什么月亮是暗红色	为什么哈萨克族人喜欢冬不拉	0
为什么淳于意流着眼泪，夸赞自己的女儿	为什么基诺族要过特毛且节	0
为什么叫蜡染布	为什叫蜡染布	1
为什么南非被称为黄金之乡	为什么彗星都拖条尾巴	0
喇叭为什么变调了	为什么先看到闪电后听到雷声	0
为什么说缝叶莺是灵巧的缝纫女	尿是怎么形成的	0
为什么说美并不等于漂亮	为什么徐光启要把棉株尖顶上的嫩芽掐断	0
为什么达斡尔族人爱往脸上抹黑	为什么说画人难画手	0
为什么蛇能在黑夜里捕捉到田鼠	为什么蛇能在黑夜捕捉到田鼠	1
柏树为什么是梨树的坏邻居	给电池充电要先放掉剩余的电，对吗	0
为什么B超能诊断疾病	为什B超能诊断疾病	1
郎世宁对中国传统绘画有何影响	为什么小朋友的心脏跳动比成人快	0
为什么拨浪鼓的声音很好听	为什么拨浪鼓的声音很好听	1
为什么收音机在晚上收台比白天多	花灯是流行于哪些民族中的民间歌舞	0
为什么说海洋和陆地是会变化的	为什么说太阳离我们很远很远	0
为什么天王星和海王星看上去呈蓝绿色	卡普里岛为什么又叫野猪岛	0
为什么说螺是建筑奇才	为什说螺是建筑奇才	1
牙齿是怎样分类的	为什么小鸡刚出壳就会走路和吃东西	0
为什么楼房外边的墙上要安装管子	烧开水时为什么有声音	0
为什么写景物要特别注意顺序	为什么植物的种子能无脚走遍天下	0
为什么中国有那么多种地方戏曲	为什么中国有那么多种地方戏曲	1
原子弹爆炸为什么会产生蘑菇云	为什么说徐悲鸿是中国美术界的一代宗师	0
鄂温克族是怎样过米阔鲁节的	神舟七号为什么选择夜间发射	0
为什么要提倡少年儿童多写自己的生活和心灵世界	为什么要提倡少年儿童多写自己的活和心灵世界	1
地球为什么会自转	为什么狗的嗅觉特别灵敏	0
为什么东乡族过春节与畲族不同	为什么说甲骨文是中国最早的书法艺术	0
为什么要使用信用卡	为什么奥运会以五色环为标志	0
为什么把足球称为世界第一运动	为什么把足球称为世界第一运动	1
人为什么感觉到冷	为什么感觉到冷	1
为什么跳芭蕾舞要立起脚尖	为什么豆类食品有益健康	0
为什么让硕硕当小炊事员，他才高兴剥豆豆	为什么让硕硕当炊事员，他才高兴剥豆豆	1
为什么丁丁知道排队了	为什么用海水洗衣服时不能用肥皂	0
什么是空间武器	什么是空间武	1
为什么有的小朋友容易患驼背	为什么叫音乐电话	0
为什么雨从天空落到地上	为什么廷廷认不出那只泥猫了	0
为什么冰川会流动	为什么冰川流动	1
为什么塔塔尔族人参加宴请时要带勺子	胫骨前痛是怎样引起的	0
为什么蛤、蚌里能产珍珠	为什么蛤、蚌里能产珍珠	1
水彩画和水粉画有什么区别	为什么有的小朋友容易患驼背	0
为什么现代通信要利用卫星	为什么说西游记是一部浪漫主义杰作	0
为什么磁卡电话能自动计费	为什么要用鼠标	0
你会打秋千吗	你会打秋千吗	1
为什么吐鲁番盆地被称为 火焰山	为什么吐鲁番盆地被称为 火焰山	1
为什么直升机要装长尾巴	为什么直升要装长尾巴	1
为什么荷兰被称为风车之国	为什么荷兰被称为风车之国	1
为什么体育锻炼后尿的颜色有时加深	烧开水时为什么有声音	0
合唱为什么要有指挥	合唱为什么要有挥	1
为什么有的湖水会分层	为什么鼻子贴在花上闻花香不好	0
为什么蜘蛛能织网	为什么小手指变成了大拇哥	0
什么是激光雷达	为什么说甜橙和橘子不一样	0
为什么水星上没有水	为什么在陶瓷上可以烧出各种美丽的颜色	0
为什么台球运动被称为力学魔术师的表演	为什么台球运动被称为力学魔术师的表演	1
为什么天上会飘雪花	猫为什会埋大便	0
为什么陈咸气坏了父亲陈万年	重金属污染是什么	0
为什么乌孜别克族家家门口挂花门帘	为什么乌孜别克族家家门挂花门帘	1
美术的含义是什么	美术的含义什么	1
你了解哪些植物的趣名	为什么英国曾被称为日不落帝国	0
为什么徐湛之要让人先救弟弟	为什么说秦始皇是中国第一个皇帝	0
火车汽笛为什么变化?浅谈多普勒效应	什么是宇宙尘？它们从哪里来	0
为什么叫做莫干山	为什么说拉斐尔的西斯廷圣母是最美的圣母像	0
动物能听懂音乐吗	为什么潜艇在水下能认路	0
为什么说诗经是我国最早的诗歌总集	为什么说诗经是我国最早的诗歌总集	1
为什么傈僳族要过刀竿节	生长着的花、果香味为什么与采摘下的不同	0
为什么树木要修剪	为么树木要修剪	1
为什么孟母三次搬家	为什么孟母三次家	1
植物为什么可以帮助人们寻找矿藏	为什么植物会有形形色色的根	0
地磁场变化吗,它变化会有什么影响	为什么蜻蜓要点水	0
为什么磁卡电话能自动计费	郎世宁对中国传统绘画有何影响	0
为什么蚯蚓没有腿和脚却会行走	为什么蚯蚓没有腿和脚却会行走	1
为什么地球会绕轴自转	为什么球会绕轴自转	1
荆轲为什么要刺杀秦王	为什么一般人右手的力气比左手大	0
莫斯塔尔城为什么出名	为什么温度计也有好几种	0
为什么三四岁幼儿讲故事，常常需要手势、动作来描述	为什么三四岁幼儿讲故事，常常需要手势、动作来描述	1
为什么炮弹的发射药中要用除铜剂	孩子为什么同家长疏远了1	0
为什么梵·高最著名的作品是向日葵	为什么物体的重量会变	0
为什么人们不能直接吃河豚	为什么人们不能直接吃河	1
为什么刘秀能重振汉室	为什么有人弹钢琴老爱出错	0
什么是景泰蓝艺术	为什么三脚架重机枪的火线越高射弹散布面积越大	0
为什么幼儿教育小学化的方式会降低幼儿大脑功能	为什么幼儿教育小学化的方式会降低幼儿大脑功能	1
商品上为什么使用条形码	商品上为什么使用条形码	1
为什么微光电视可以进行战场监视	为什么中国人自称为炎黄子孙	0
植物为什么可以帮助人们寻找矿藏	为什么细嫩的幼苗能拱动石板	0
卫星是怎样发射的	卫星是怎发射的	1
花生为什么又叫落花生	为什么皮肤晒黑是正常现象	0
晚香玉为什么夜来香	柏树为什么是梨树的坏邻居	0
歌曲二字的含义是什么	姜太公为何要用直钩钓鱼	0
为什么阴雨天多南瓜就结不好	为什么阴雨天多南瓜就结不好	1
为什么有些男孩子也爱害羞	为什么有些男孩子也爱羞	1
为什么马戏团的小狗能算算术	宇航员在太空中怎样称体重	0
红、黄、蓝为什么被称为三原色	为什么建筑物会是多种多样的	0
为什么病毒可致人于死地	水杉是名副其实的世界爷吗	0
为什么会形成东非大裂谷	太空育种的原理是什么	0
为什么小军说自己笨	为什么望远镜能使我们看清远处的东西	0
为什么青年人脸上容易生青春痘	为什么青年人脸上易生青春痘	1
为什么给鸡戴红色眼镜可以多产蛋	怎样更准确地审清题意	0
为什么不用刀切木头，而用锯锯木头	为什么不用刀切木头，而用锯锯木	1
崂山为什么被称作名山	崂山为什么被称作名山	1
谁是夏朝第一位国君	为什么会出现开元盛世	0
为什么地球中心热,怎样测其温度	为什么美术又叫造型艺术	0
为什么生白薯没有烤白薯甜	大雪后为什么很寂静	0
为什么让硕硕当小炊事员，他才高兴剥豆豆	鄂温克族是怎样过米阔鲁节的	0
为什么我国古代的书刻在石头上	为什么我国古代的书刻在石头上	1
为什么会出现腰椎间盘突出	为什么会出现腰椎间盘突出	1
核潜艇和普通潜艇的区别是什么	为什么不宜带幼儿到公共场所活动	0
为什么王祥吃东西，王览总要先尝一口	为什么王祥吃东西，王览要先尝一口	1
为什么地球会绕轴自转	为什么王献之能把墨点变母牛	0
为什么古莲子为我国寿命最长的种子	运动后肌肉酸痛怎么办	0
为什么称这棵连株榕树为最大的榕树	为什么儿童团长王璞能抓住特务	0
男人与女人的身体有什么差别	为什么眼镜蛇发怒时脖子会变粗	0
套马是哪个民族的传统体育项目	静电复印机是怎样工作的	0
为什么鸟的歌声特别婉转动听	为什么鸟的歌声特别婉转动听	1
为什么说音乐能寓教于乐	为什么说音乐能寓教于乐	1
红场为什么不能算世界上最大的广场	红场为什么不能算世界上最大的广场	1
为什么薄薄的圆纸片能立起来	为什么海蜇会螫人	0
你能让铅笔尖向下直立在手指上吗	你能让铅笔尖向直立在手指上吗	1
崂山为什么被称作名山	为什么瑶族人庆祝达努节	0
为什么指出自己缺点的朋友是好朋友	为什么指出自己缺点的朋友是好朋友	1
为什么潜艇在水下能认路	你知道魏晋南北朝时期的志怪轶事小说吗	0
炒栗子的糖砂有什么功用	小朋友唱的歌曲为什么有前奏和间奏	0
月全食的时候为什么月亮是暗红色	为什么要多吃鱼	0
为什么人工流产会导致不孕	为么人工流产会导致不孕	1
麦奇里湖为什么是世界上的一个奇迹	为什么不要生吃杏的种仁	0
为什么听自己录音会觉得声音变了	为什么成熟的水果会变色	0
爆炸时寂静区是怎样形成的	爆炸时寂静区是怎样形成的	1
为什么蚯蚓没有腿和脚却会行走	冬天运动时出汗要注意什么	0
怎样使鸡肉更鲜美	猜猜他在干什么	0
为什么巨杉是 世界巨木之首	为什么潜艇里的人在水下不会憋死	0
有些坦克炮的抽烟装置为什么偏置	有些坦克炮的抽烟装置为什么偏置	1
为什么陈咸气坏了父亲陈万年	为什么陈咸气坏了父亲陈万年	1
为什么彩色胶卷能拍出彩色照片	为什么碰伤的皮肤处会有乌青块	0
为什么植物会啃石头	为什么蛇能吞下比它的头大得多的食物	0
为什么小艾虎能打得过大老虎	为什么小虎能打得过大老虎	1
少女为什么会来月经	为什么藕有许多小洞洞	0
你知道黎族有哪些礼仪和禁忌	什么是四大科学难题	0
为什么摩擦过的尺子能吸小纸片	为什么鄂温克族人喜欢驯鹿	0
地球同步轨道就是地球静止轨道吗	为什么我国各民族都有传统乐器，你知道是什么吗	0
为什么有人弹钢琴老爱出错	为什么要多吃鱼	0
为什么浓甘油不宜搽脸	为什么收音机在晚上收台比白天多	0
什么是空间武器	什么是空间武	1
飞船最佳发射窗口是怎样确定的	脾气和脾有关吗	0
为什么日食发生在初一而不是十五	为什么激光武器有很强的杀伤力	0
为什么它是世界上最小的鸟	为什么它是世界上最小的鸟	1
放大镜是怎样把物体放大的	为什么孟母三次搬家	0
为什么脑子会越用越灵	为什么毛泽东把饭让给小朋友吃	0
为什么盲鳗可以吃比它大得多的鱼	为什么秦皇岛不是岛	0
为什么藏族人要在同一天到河里洗澡	为什么把花的叶子摘了，花就死了	0
为什么有些植物散发的气味令人感到清爽	为什么直升机要装长尾巴	0
为什么在夏天自行车胎容易放炮	为什么在夏天自行车容易放炮	1
为什么嗅觉有时会失灵	什么是舰载机	0
为什么英国曾被称为日不落帝国	为么英国曾被称为日不落帝国	1
为什么植物离不开空气	为什么植物离不开空气	1
蠡园为什么是中外游人迷恋的地方	为什么边尔村的泉被称为神泉	0
日本庆祝男孩节为什么要挂鲤帜	为什么小伙计能成为大画家	0
为什么荷兰被称为风车之国	为什么要让玩具成为孩子的好伙伴	0
为什么小狗睡觉时要将耳朵贴在地上	为什么狗睡觉时要将耳朵贴在地上	1
为什么云南大理最大的集市叫三月街	经常吃生鸡蛋的人为什么会使头发早白	0
为什么不能拿大伙儿的东西	为什么拖拉机的前后轮子不一样大	0
神舟号飞船为什么选在晚上发射	为什么植物间有相亲和相克的关系	0
为什么孙子兵法被誉为 兵学鼻祖 	为什么文艺创作中允许虚构	0
唱歌跑调与情绪有关吗	为什么打电话会有回声	0
为什么石灰岩洞中会生长着石笋和钟乳石	为什么石灰岩洞中会生长着石笋和钟乳石	1
为什么下雨前小虫特别多	电风扇能降低室温吗	0
为什么彗星都拖条尾巴	为什么彗星都拖条尾巴	1
鱼为什么比肉容易坏	鱼为什么比肉容易坏	1
为什么指南针有不同的形状，可又总指着南方	为什么指南针有不同的形状，又总指着南方	1
为什么电灯泡会发光	为什么灯泡会发光	1
怎样使笔尖好用	为什么海蜇会螫人	0
为什么山上的松树特别多	为什么晚上捕鱼用灯能引诱鱼群	0
为什么没煮熟的豆浆不能喝	为什么没熟的豆浆不能喝	1
为什么红灯停，绿灯行	为什么丹麦被称为童话王国	0
为什么计算机的时钟在断电时仍能正常工作	为什么植物生长离不开氮肥	0
你知道高山流水的故事吗	你知道高山流水的故事吗	1
生活常识灭火器为什么能把火扑灭	山洞为什么被叫做东海龙宫	0
圣文森特角为什么有天涯海角之称	为什么阿昌族人喜欢户撒刀	0
雪是怎样形成的	什么是外来词	0
俄罗斯族有什么礼仪及禁忌	为什么要用互联网	0
为什么拖拉机的前后轮子不一样大	海鸥为什么总追着轮船飞	0
为什么一幅好画不能随意改动	为什么切开的茄子放久了表面发黑	0
为什么植物会啃石头	为什么说清明上河图是历史写真集	0
重金属污染是什么	为什么毒蛇的肉也可以吃	0
为什么洗澡时手上会有许多皱纹	为什么澡时手上会有许多皱纹	1
为什么人人要有副整齐的牙齿	为么人人要有副整齐的牙齿	1
为什么周处要痛改前非	为什么周处要痛改前非	1
为什么有些城市的电话号码特别长	为什么说用嘴呼吸不健康	0
工艺美术为什么会包括许许多多的内容	猪为什么用嘴巴拱泥土	0
什么是太阳风	为什么做眼保健操能预防近视	0
高空的气温为什么低	空的气温为什么低	1
圣克劳德为什么叫做烟斗之城	为什么大禹能够治水成功	0
为什么在陶瓷上可以烧出各种美丽的颜色	为什么幼儿经常自言自语	0
为什么端午节吃粽子	为什么舌头能辨别味道	0
为什么会爆发安史之乱	为什么三瓣石那么神秘	0
为什么水不能燃烧	为什么水不能燃烧	1
为什么用扇子扇炉火越扇越旺，而扇蜡烛却一扇就灭	为什么用扇子扇炉火越扇越旺，而扇蜡烛却一扇就灭	1
为什么切掉一只肾的人还能活着	为什么我国人民要在喜庆节日放鞭炮	0
为什么杂技演员表演水流星时，水不会洒出来	萤火虫为什么会一闪一闪的发光	0
为什么说太阳比地球大	为什么要把羊赶出来	0
为什么早晚的太阳发红	为什么冰梅石是常州奇观	0
为什么房间里洒了水会凉快些	为什么在夏天狗总是伸着舌头喘气	0
喇叭为什么变调了	为什么冷饮不可多吃	0
为什么轰炸机被称做天空杀手	为什么四大名著能经久不衰	0
癌细胞为什么会转移	为什么把天王星称做冷行星	0
为什么有淡水鱼和盐水鱼之分	为什么不赞成青少年饮酒	0
为什么网络有局域网、城域网和广域网之分	命题作文为什么要认真审题	0
为什么传说天上有十个太阳	为什么夏天下雨前天气特别闷热	0
菟丝子为什么被称作植物界的寄生虫	为什么短跑运动员穿上钉子鞋参加比赛时跑得就快	0
为什么电影中会有慢动作镜头	自行车倒千斤怎么办	0
为什么摸了核桃的青皮，手会黑	为什么摸了核桃的青皮，手会黑	1
为什么不是一个月看到一次日、月食	为什么不是一个月看到一次日、月食	1
初学画画的人为什么最好先画水粉画	初学画画的人为么最好先画水粉画	1
为什么说电脑毕竟不能代替人脑	世界上为什么会有五光十色的湖	0
为什么白天看不见星星	为什么一般人右手的力气比左手大	0
为什么说有办法能把海水里的盐去掉	怎样用可乐瓶做小姑娘的裙子	0
为什么小朋友容易被烫伤	为什么小朋友容易被烫伤	1
为什么幼儿好动，不易约束自己	为什么幼儿动，不易约束自己	1
为什么把天王星称做冷行星	为什么把天王星称做冷行星	1
为什么雨天电话容易串音	为什么说月亮也可能有卫星	0
现代银行为什么开始广泛应用计算机	为什么画画时会用眼睛比会用手更重要	0
为什么子弹在飞行时旋转	为什么不能在玻璃上滑冰	0
为什么早餐很重要	为什么早餐很重要	1
为什么要培养孩子良好的睡眠习惯	楔式炮闩体为什么做成棱柱形	0
为什么让硕硕当小炊事员，他才高兴剥豆豆	为什么让硕硕当小炊事员，他才高兴剥豆豆	1
为什么有些孩子会挑食和拒食	为什么飞鱼会飞	0
为什么人的皮肤会有不同的颜色	为什么王羲之被奉为书圣	0
核潜艇和普通潜艇的区别是什么	为什么说土星是星中美人	0
为什么说加拿大是枫叶之邦	塔吉克族是怎样过迄脱迄迪尔节的	0
怎样用树叶制书签	为什么临碑帖对提高书法水平能起很大作用	0
什么是机器人	八哥在水牛背上啄什么	0
为什么不让皇帝看起居注	为什么环卫工人不能烧落叶	0
为什么商品要采用条形码	为什么商品采用条形码	1
为什么孙康要在雪地里读书	为什么孙康要在雪里读书	1
为什么冬天孩子的手和脸容易皴裂	为什么海豹不睡大觉	0
为什么乌龟身上会出汗	为什么海水无色而大海蓝色	0
为什么工厂的烟囱要盖得很高很高	为什么鸟有三个眼睑	0
为什么自己挠胳肢窝不会痒	为什么受伤的水果会变黑	0
被遗弃在太空的尸体最终会怎样	为什么现代通信要利用卫星	0
为什么会形成东非大裂谷	为什么会形成东大裂谷	1
原子弹爆炸为什么会产生蘑菇云	为什么大熊猫是国宝	0
为什么鱼缸里的水草会冒泡	为什么用瓶盖做成的小乐器声音很好听	0
怀孕后为什么要少吃米饭	为什么他能把小铁球够上来	0
风是怎样形成的	风是怎样形的	1
为什么幼儿学反面角色快	为什幼儿学反面角色快	1
冷水和热水哪个沸腾快	冷水和热水哪个沸腾快	1
为什么幼鸽爱把嘴伸到老鸽嘴里	为什么幼鸽爱嘴伸到老鸽嘴里	1
为什么成熟的水果会变色	为什么成熟的水果会变色	1
为什么潜艇在水下能认路	为什么潜艇水下能认路	1
为什么路温舒要把蒲草做成书本	为什么路温舒要把蒲草成书本	1
中国画为什么有很多画线条的方法	爬云梯的梯子短一些是否更安全	0
为什么雷雨时，先看到闪电，后听到雷声	为什么雷雨时，先看到闪电，后听到雷声	1
为什么步枪口径越来越小	为什么说植物的种子是大力士	0
为什么聪明的贝贝不会区分各种几何图形	为什聪明的贝贝不会区分各种几何图形	1
什么是黑客	为什么天空中会出现流星	0
为什么只有同种植物的花粉才能受精	为什么说甜橙和橘子不一样	0
为什么说巨人岬是大自然的杰作	为什么提倡戒烟	0
为什么郑板桥能把河中的五彩石夹上来	为什么称红楼梦是我国古典长篇小说中最杰出的作品	0
为什么张溥把自己的书房叫作七录书斋	为什么张溥把自己的书房叫作七录书斋	1
为什么牛吃完草后还不停地咀嚼	为什么闽南的竹子被称为奇竹	0
为什么说冬冬是个讲信用的好孩子	为什么磊磊的小飞机能变成机器人	0
为什么冬天窗玻璃上有冰花	为什么冬天窗玻璃上有冰花	1
车闸不灵活怎么办	伊斯兰教为什么要过圣纪节	0
为什么说大脑是人体的指挥中心	为什么说大脑是人体的指挥中心	1
为什么要给小草记功劳	为什么要给小草记功劳	1
景颇族有什么礼仪及禁忌	为什么火焰山至今还有唐僧的拴马桩	0
什么是贬义词	什么是贬义词	1
为什么吃饭前后不要做剧烈活动	为什么说土星是星中美人	0
昆虫是怎样保护自己的	为什么梵·高最著名的作品是向日葵	0
你知道高山流水的故事吗	为什么雷雨时，先看到闪电，后听到雷声	0
为什么吃了没煮熟的扁豆会中毒	为什么电视发射天线那么高	0
为什么说我国的国画是国宝	为什么说她是聪明的小姑娘	0
为什么把家春秋称为现代红楼梦	为什么把家春秋称为现代红楼	1
运动的物体为什么都存在惯性	运的物体为什么都存在惯性	1
太空育种的原理是什么	太空育种的理是什么	1
初学画画的人为什么最好先画水粉画	什么是单音词、复音词	0
为什么火焰山至今还有唐僧的拴马桩	为什么大熊猫是国宝	0
为什么老人故意为难张良	为什么人会做梦	0
为什么天空中会出现流星	为什么天空中会出现星	1
为什么孩子肚子疼不能随便吃止疼药	为什么吃了没煮熟的扁豆会中毒	0
为什么瓶子里的水不能一下倒出来	怎样使笔尖好用	0
为什么不用纯酒精消毒	为什么海水又咸又苦	0
你知道高山流水的故事吗	为什么说应该提倡幼儿双手并用	0
为什么说毛毛虫是杨树的花	为什么竹子长得特别快	0
海水为什么是咸的	为什么说太阳是太阳系的家长	0
什么是微光夜视仪	什么是微光夜仪	1
为什么下雨前小虫特别多	为什么下雨前小虫特别多	1
为什么幼儿喜欢拆卸玩具	为什么不要蒙头睡觉	0
为什么卫星能观察到地面的情况	为什么小朋友不要多吃油炸的食物	0
为什么夏天星星比冬天多	为什么夏天星星比冬天多	1
为什么火箭要垂直发射	为什么火箭要垂直发	1
布依族的六月六、四月八是怎么回事	依族的六月六、四月八是怎么回事	1
为什么地球是圆的而地面是平的	为什么地球是圆的地面是平的	1
什么是黑洞	为什么有些男孩子也爱害羞	0
昆虫怎样吃东西	为什么冬天枯死的草，春天能发芽	0
蛇为什么喜欢在春天蜕皮	古城为什么定名为无锡	0
什么是宽带	什么是宽	1
为什么计算机的时钟在断电时仍能正常工作	为什么马拉松长跑的距离规定为42195米	0
为什么秦皇岛不是岛	为什么秦皇岛不是岛	1
为什么称王莲为 莲中之王	为什么张骞要出使西域	0
为什么澳大利亚被称为骑在羊背上的国家	为什么说四川省的铁树林是我国最大的铁树林	0
神舟七号为什么选择夜间发射	神舟七号为什么选择夜间发射	1
为什么大禹治水的故事至今流传	为什么下雨前小虫特别多	0
为什么会形成东非大裂谷	为什么会形成东非大裂谷	1
为什么人有脉博	为什么不要空腹喝牛奶	0
为什么导弹靠近目标才引爆	什么导弹靠近目标才引爆	1
为什么受伤的水果会变黑	为什么受伤的水果会变黑	1
为什么边尔村的泉被称为神泉	为什么小鸡刚出壳就会走路和吃东西	0
为什么要重视孩子的眼外伤	为什么要重视孩子的眼外伤	1
为什么最热的地方不在赤道	为什么地球内部可以分成许多圈层	0
为什么吃水果也要适量	花粉长什么样呢	0
中国画为什么要用毛笔来画	为什么闵子骞受了继母的虐待，却还要原谅她	0
为什么蛤、蚌里能产珍珠	为什么蛤、蚌里能产珍珠	1
为什么有的柑桔没有核	生活常识灭火器为什么能把火扑灭	0
为什么月亮有时大，有时小，有时明，有时暗	为什么花也要睡觉	0
画中国画的纸为什么同画其他画的纸不一样	为什么叫民歌	0
为什么眼睛视力会有变化	为什么眼睛视力会有变化	1
为什么扁平足对孩子有影响	·!!·为什么方承观立志苦学	0
蠡园为什么是中外游人迷恋的地方	蠡园为什么是中外人迷恋的地方	1
为什么鲸类有流眼泪的习性	为什么鲸类有流眼泪的习性	1
什么是步枪	为什么轰炸机被称做天空杀手	0
咸蛋的蛋黄为什么会出油	!·为什么寒冷的冬天鸟也不怕冷	0
为什么门巴族人都喜欢用木碗	为什么称喊瀑和喊雨	0
为什么纸盒做的小火车能拐弯	为什么称喊瀑和喊雨	0
为什么通用机枪多为轻重两用	为么通用机枪多为轻重两用	1
人为什么要经常眨眼	人为么要经常眨眼	1
为什么地球会绕轴自转	为什么地会绕轴自转	1
为什么天上的星星有的亮、有的暗	为什么天上的星星有的亮、有的暗	1
重金属污染是什么	重金污染是什么	1
为什么有的鸟腿上套有一个金属环	为什么蚯蚓是植物的好朋友	0
为什么摘下来的蔬菜会变蔫	为什么玻璃器皿遇忽冷忽热会裂开	0
为什么不能吃死鳝鱼	为什么不能吃死鱼	1
为什么表演快板书要边说边打竹板	为什么表演快板书要边说边打竹板	1
为什么叫书法	为什叫书法	1
为什么花癫患者都是青少年	为什么笔是文房四宝中的一宝	0
为什么发豆芽要常换水	大气中为什么会出现晕	0
为什么练完体操后比练习时气喘得厉害	为什么人造卫星环绕地球的轨道不一样	0
为什么说雕刻和雕塑不一样	为什么宰相管李泌叫小友	0
如果人们能够进入贯穿地球的隧道中，将发生什么事情	傣族为什么过泼水节	0
怎样除去镜片上的水雾	为什么射击时对不同距离的目标要定不同的表尺	0
为什么睡觉要向右侧卧	为什么睡觉要向右侧卧	1
为什么沙发比一般椅子松软有弹性	为什么沙发比一般椅子松软有弹性	1
为什么泥鳅要吐泡	为什么泥要吐泡	1
为什么耶路撒冷被称为圣城	为什么说要用心去观察	0
为什么大禹治水的故事至今流传	同样的粘沙土为什么能烧成不同的砖	0
为什么牛吃完草后还不停地咀嚼	武器为什么会出汗	0
为什么吃饭时说话会呛着	为什么吃饭时说话会呛着	1
佛手瓜的种子为什么不能与瓜分开	为什么王祥吃东西，王览总要先尝一口	0
为什么航空母舰特混编队特别庞大	什么是数字电视	0
为什么曹丕命令曹植在七步之内作诗一首	秦始皇兵马俑为何号称世界第八大奇迹	0
为什么花有大小美丑之分	为什么岳柱对名画提出批评	0
为什么蜂窝都是六角形的	为什么蜂窝都是六角形的	1
武器为什么会出汗	为什么鱼雷能在海中不同深度上航行	0
熊为什么冬眠？冬眠为什么不脱水	为什么立交桥上会有接缝	0
有的沿海岛屿降水为什么比邻近大陆还少	为什么旋转球不走直线	0
为什么茶树都生长在南方	为什么茶树生长在南方	1
为什么说用嘴呼吸不健康	为什么说用嘴呼吸不健康	1
为什么鱼要有鱼鳔	什么鱼要有鱼鳔	1
怎样使鸡肉更鲜美	为什么人着凉就可能得病	0
汽车转弯或刹车安全由谁定	汽车转弯刹车安全由谁定	1
为什么藕有许多小洞洞	为什么藕许多小洞洞	1
为什么指南针有不同的形状，可又总指着南方	邮票染了怎么办	0
老鼠为什么乱啃东西	老鼠为什么乱啃东西	1
为什么叫音乐电话	为什么叫音乐电话	1
怎样去菜馅中的水分	怎样去菜馅中的水	1
为什么地球会绕轴自转	为什么秋天、冬天会有雾	0
收音机为什么会有杂音	排球运动是怎样产生的	0
为什么要开除冥王星	为什么要开除冥王	1
为什么称作一勺之多泉	为什么猴岛成为旅游中的一个热点	0
唐宋八大家是哪几位	为什么水星上没有大气层	0
玉泉山的泉水为什么叫天下第一泉	玉泉山的泉水为什么叫天下第一	1
为什么患肾炎的人仍能参加体育活动	为什么运动时应有意识地使呼吸变得深长和缓慢	0
为什么兵马俑坑是名胜古迹	人为什么会打嗝	0
为什么有的人鼻子容易出血	为什么火箭顶端要安装一根天线样的钢针	0
为什么深海里的鱼会发光	桌面开裂怎么办	0
彗星会撞上地球吗	彗星会撞地球吗	1
为什么说喜鹊是田野卫士	为什么孩子晚上睡觉容易出汗	0
为什么莎莎唱歌喜欢用小沙锤来伴奏	什么是太阳风	0
为什么会爆发第二次世界大战	为什么会出现开元盛世	0
曹操是一代枭雄还是大政治家	曹操是一代枭雄还是大政治家	1
为什么应该培养随手查字典的习惯	为什么桥都设计成凸形的	0
傣族有哪些礼仪和禁忌	傣族有哪些礼仪和禁忌	1
套马是哪个民族的传统体育项目	套马是哪个民族的传统体育项目	1
地球同步轨道就是地球静止轨道吗	植物怎样抵御动物的侵害	0
注射青霉素前为什么要做皮试	为什么红比拉鱼被称为危险动物	0
为什么房间里洒了水会凉快些	星系会互相吞并吗	0
你知道木偶奇遇记这本书吗	什么是磁悬浮列车	0
为什么水滴能在荷叶上滚来滚去	为什么冬天孩子的手和脸容易皴裂	0
为什么猪流感让人闻之色变	为什么猪流让人闻之色变	1
为什么说电脑毕竟不能代替人脑	为什么幼儿不会听反话	0
为什么自己挠胳肢窝不会痒	为什么自己挠胳肢窝不会	1
为什么蝙蝠是哺乳动物	为什么桂林山水如此奇丽秀美	0
为什么人会做梦	为什么人会做梦	1
为什么摄像机摄像时不需要对焦和曝光	为什么毛笔要用动物身上的毛来做	0
飞船最佳发射窗口是怎样确定的	为什么李崇将孩子判给苟泰	0
!·为什么冬季玻璃杯会炸	怎样煮蛋不爆	0
为什么毛冠鹿的头上没长角	人为什么会变老	0
为什么称我们的国家是诗国	为什么响尾蛇的尾巴会发响	0
神舟号飞船为什么选在晚上发射	为什么人一冷皮肤上就会起鸡皮疙瘩	0
为什么颐和园内的铜牛是我国最大的铜牛	为什么乌龟身上会出汗	0
男孩子为什么爱意气用事	男孩子为什么爱意气用事	1
为什么幼儿会认为水变多了、线变长了	胆的大小与胆量有关系吗	0
为什么傣族人喜欢住竹楼	为什么美国犹他州的天然拱比其他任何地方都多	0
为什么核检查有不同的方法	为什么核检查有不同的方法	1
为什么大熊猫是国宝	为什么熊猫是国宝	1
雷声为什么隆隆作响很长时间	家用电表分表与总表为什么又误差	0
为什么王祥吃东西，王览总要先尝一口	什么是冲锋枪	0
为什么把花的叶子摘了，花就死了	为什么泰国被称为大象之邦	0
为什么说漳州是水仙之乡	什么是武器的战斗性能	0
为什么丹丹画的长颈鹿脖子比五层楼还高	什么是鱼雷艇	0
为什么萧遥欣要劝朋友爱护鸟	维吾尔族有什么礼仪、禁忌	0
为什么他们能走过水坑	为什么天空是蓝色的	0
为什么荷兰被称为风车之国	水杉是名副其实的世界爷吗	0
维吾尔族有什么礼仪、禁忌	流星雨怎么形成的	0
为什么有的坦克能在陆地和水中行使	为什么幼儿喜欢拆卸玩具	0
为什么叫姐妹山	为什么叫姐妹	1
海水为什么是蓝色的	为什么说画鬼容易画犬难	0
为什么小鸡刚出壳就会走路和吃东西	为什么小鸡刚出壳就会走路和吃东西	1
怎样旋开玻璃瓶上太紧的铁盖	怎样旋开玻璃瓶上太紧的铁盖	1
为什么双双小朋友常出现有意破坏的行为	为什么云南大理最大的集市叫三月街	0
为什么短跑运动员穿上钉子鞋参加比赛时跑得就快	套马是哪个民族的传统体育项目	0
为什么要开除冥王星	为什么取名为鹅泉	0
为什么哈雷彗星能准时回归	为什么鱼有鳞片	0
为什么岳飞会惨死风波亭	为什么我国古代的书刻在石头上	0
为什么说剪纸是一门中国的古老艺术	为什么说剪纸是一中国的古老艺术	1
为什么鉴真和尚要东渡日本	为什么门前有西瓜苗	0
为什么青铜宝剑不会生锈	为什么李世民会发动玄武门之变	0
为什么碳钟可以测定古文物的年龄	为什么碳钟可以测定古文物的年龄	1
为什么夏天人的皮肤上容易长出小红点	为什么巨杉是 世界巨木之首	0
为什么郑成功能收复台湾	为什么要学习汉语拼音	0
火箭升空的瞬间，地面升起的庞大白色气团是什么东西	火箭升空的瞬间，地面升起的庞大白色气团是什么东西	1
什么是外来词	什么是来词	1
为什么说四库全书是我国最大的文献丛书	为什么人参那么珍贵	0
为什么西方人厌恶13这个数字	为什么西方人厌恶13这个数字	1
为什么人会有冷和热的感觉	为什么能用瓶子奏出曲子来	0
阅读中碰到不懂的文言词汇该怎么办	为什么人会做梦	0
为什么长吻鱼喜欢接吻	为什么长吻鱼喜欢接吻	1
为什么胡杨能在沙漠中生存	为什么胡杨能在沙漠生存	1
为什么胡杨能在沙漠中生存	为什胡杨能在沙漠中生存	1
为什么萌萌拆半导体	为什么大禹能够治水成功	0
为什么说清明上河图是历史写真集	为什么说清明上河图是历史写真集	1
为什么射击后未爆的炮弹不许乱动	为什么射击后未爆的炮弹不许乱动	1
为什么洗衣机能洗干净衣服	为什么有些磺胺类药要与小苏打合用	0
为什么内蒙古举行那达慕大会时那么热闹	为什么鸡和鸭有翅膀却飞不高呢	0
中国画为什么有工笔画和写意画之分	为什么严寒的南北极也有植物安家落户	0
什么是绿色冰箱	为什么陈继要钻进苇丛里	0
为什么火车到站后，工人要用锤子在车下敲打	为什么黄花菜要晒干以后才能吃	0
有头上长角的鱼吗	为什么戏曲表演中有些演员要画花脸	0
为什么景颇族人每年要举行木脑盛会	为什么巡航导弹离不开数字化地图	0
天下第二泉为什么远近闻名	为什么狮子大王收到的是一袋水	0
为什么廷廷认不出那只泥猫了	为什么廷廷认不出只泥猫了	1
冰为什么这么滑	冰为么这么滑	1
为什么手枪用布包起来不好	人为什么会变老	0
为什么摩擦过的尺子能吸小纸片	为什么湖水夏天浑浊，秋天清亮	0
为什么盲鳗可以吃比它大得多的鱼	为什么盲鳗可以吃比它大得多的鱼	1
眼镜腿转动不灵怎么办	为什么有的音乐叫激光音乐	0
为什么柿子有的甜、有的涩	!·为什么几片云彩会把整个太阳遮住	0
为什么狗的嗅觉特别灵敏	为什么阿昌族人喜欢户撒刀	0
为什么吃饭前后不要做剧烈活动	为什么一条电话线路上可以通多路电话	0
为什么有两个西湖	为什么星星、月亮不会掉下来	0
为什么早晚的太阳发红	为什么蛇能吞下比它的头大得多的食物	0
为什么叫书法	为什么红豆又叫相思豆	0
为什么罐装的自动喷剂喷了一会罐身会变凉	为什么罐装的自动喷剂了一会罐身会变凉	1
牛蛙的肤色为什么会改变	为什么彩电对天线的要求特别高	0
为什么说太阳是太阳系的家长	为什么狗认识路	0
为什么别府温泉首屈一指	为什么侦察机能作空中间谍	0
为什么小朋友的心脏跳动比成人快	为什么故宫是最大的宫殿	0
为什么要研究空间脑科学	为什么房顶上能长出小树小草	0
为什么脱下的衣服不要盖在被子上	为什么脱下的衣服不要盖在被子上	1
为什么鄂温克族人喜欢驯鹿	为什么周处要痛改前非	0
为什么可乐瓶变成了可乐猪	为什么可乐瓶变成了可乐猪	1
为什么吴昂自愿住进牛棚	为什吴昂自愿住进牛棚	1
为什么南海的小岛数也数不清	为什么南的小岛数也数不清	1
为什么鼻子能闻出各种气味	为什么云有各种不同的颜色	0
为什么小麻雀每天晚上飞来和杨宝做伴	为什么小麻雀每天晚上飞来和杨宝做伴	1
为什么说剪纸是一门中国的古老艺术	为什么黑墨不能当染布的颜料	0
为什么有的植物开花，有的植物不开花	为什么有的植物开花，有的物不开花	1
为什么已受外力作用的地雷应就地销毁	为什么称我们的国家是诗国	0
为什么指南针能指南	为什么指南针能指南	1
什么是微电子学	为什么金星最亮	0
为什么称这棵连株榕树为最大的榕树	为什么把从我国到古罗马国的路称作丝绸之路	0
为什么主战坦克比普通坦克厉害	为什么不能用油料浸洗炮、枪弹	0
为什么说世界上的东西都是由元素组成的	为什么要给星星取名字	0
为什么勤奋读书可以陶冶性情	为什么勤奋书可以陶冶性情	1
为什么门巴族人都喜欢用木碗	为什么巴族人都喜欢用木碗	1
炒栗子的糖砂有什么功用	炒栗子的糖砂什么功用	1
为什么要修筑万里长城	为什么要修筑万里长城	1
为什么夏天的夜晚还那么热	为什夏天的夜晚还那么热	1
为什么说太阳比地球大	为什说太阳比地球大	1
为什么患肾炎的人仍能参加体育活动	什么患肾炎的人仍能参加体育活动	1
为什么让硕硕当小炊事员，他才高兴剥豆豆	为什么让硕硕当小炊事，他才高兴剥豆豆	1
为什么说不老松是我国最古老的一棵松树	笔杆上的小孔有什么功用	0
火星上有生命吗	火星上有生命吗	1
为什么壮壮小朋友最欣赏柿子儿子	为什么壮壮小朋友最欣赏柿子儿子	1
为什么寄居蟹和海葵是好朋友	为什么叫马跑泉	0
为什么说有办法能把海水里的盐去掉	为什么说有办法能把海水里的盐掉	1
为什么说不老松是我国最古老的一棵松树	为什么水能灭火	0
运动后肌肉酸痛怎么办	昆虫怎样吃东西	0
为什么说螺是建筑奇才	为什么说螺是建筑奇才	1
为什么有些孩子会挑食和拒食	为什么晴天时显得天高，阴天时显得天矮	0
为什么每个人的指纹不一样	为么每个人的指纹不一样	1
蠡园为什么是中外游人迷恋的地方	为什么冰梅石是常州奇观	0
为什么会爆发安史之乱	为什么恒星会发光	0
为什么儿童不能喝酒	为什么儿童不能喝酒	1
湖泊是怎样形成的	为什么有时候蜻蜓飞得很低	0
为什么说黄鹂是益鸟	为什么秦皇岛不是岛	0
为什么韭菜割了以后还能再生长	为什么要提倡写读书笔记	0
小学生不喜欢弹钢琴怎么办	小学生喜欢弹钢琴怎么办	1
为什么幼儿好动，不易约束自己	为什么幼儿好动，不易束自己	1
为什么水滴能在荷叶上滚来滚去	为什么水滴能在叶上滚来滚去	1
什么叫干画法和湿画法	什么干画法和湿画法	1
为什么说秦始皇是中国第一个皇帝	为什么吃豆腐最好配点海带	0
人的阑尾有什么功能	为什么要提倡多读好的课外书	0
为什么戴碧荣会失去左臂和左腿	植物怎样抵御动物的侵害	0
什么是和平号空间站	什么是和平号空间站	1
为什么做脑电图不会损伤大脑	为什么做脑电图不会损伤大脑	1
为什么马头琴是蒙古族人民最喜爱的乐器	火星上有生命吗	0
为什么睡前要用热水洗脚	为什么笔是文房四宝中的一宝	0
为什么汽车玻璃和家用玻璃不一样	为什么汽车玻璃和家用玻璃不一样	1
为什么会形成各式各样的岛屿	为什么会形成各各样的岛屿	1
为什么冰梅石是常州奇观	畲族有什么礼仪及禁忌	0
为什么海水又咸又苦	为什么有的幼儿在陌生人和集体面前表现得很胆怵	0
为什么凹镜中看到的图像是倒置的	为什么凹镜中看到图像是倒置的	1
什么是微电子学	什么是微电子学	1
少数民族是怎样巧用箭毒树的	为什么雨从天空落到地上	0
!·为什么寒冷的冬天鸟也不怕冷	!·为么寒冷的冬天鸟也不怕冷	1
为什么中国画常把彩色的东西画成黑白的	为什么中国画常把彩色的东西画成黑白的	1
为什么把足球称为世界第一运动	为什么把足球称为世界第一运	1
怎样把开水冷却	怎样开水冷却	1
为什么耶路撒冷被称为圣城	为什么投降举白旗	0
为什么听自己录音会觉得声音变了	为什么景颇族人吃饭用叶子当碗碟	0
哈哈镜照人为什么会变样	哈哈镜照人为什么会变样	1
为什么称巴西是足球王国	什么是冲锋枪	0
为什么刚掀开的冷冻啤酒瓶口会冒出雾气	为什么刚掀开的冷冻啤酒瓶口会冒出气	1
为什么肥皂能清洗手部的脏污	水滴落沸油中会怎样	0
为什么计算机会产生千年虫问题	为什么王允之要故意装醉	0
为什么望远镜能使我们看清远处的东西	为什么人在打呵欠时会眼泪汪汪	0
为什么我国古代的书刻在石头上	为什么我国代的书刻在石头上	1
为什么古莲子为我国寿命最长的种子	为什么古莲子为我国寿命最长种子	1
为什么哈密瓜特别甜	为什么哈密瓜特别甜	1
什么是马一角和夏半边	什么是马一角和夏半边	1
为什么说她是聪明的小姑娘	为么说她是聪明的小姑娘	1
为什么有的飞机翼尖向上折起	为什么彩电对天线的要求特别高	0
为什么海鸟喜欢在海上飞翔	为什么半可燃药筒能被广泛应用	0
内弹道学的定义及任务是什么	内弹道学的定义及任务什么	1
姜太公为何要用直钩钓鱼	为什么火车的车窗有两层玻璃	0
什么是马一角和夏半边	什么是马一角和夏半边	1
为什么看鱼鳞能知道鱼的年龄	为什么看鱼鳞能知道鱼的年龄	1
景颇族有什么礼仪及禁忌	颇族有什么礼仪及禁忌	1
古城为什么定名为无锡	古城为什么定名为无锡	1
为什么岳飞会惨死风波亭	纳西族有哪些礼仪和禁忌	0
为什么人一哭就会流鼻涕	为什么说中国是风筝的故乡	0
为什么人有头皮屑	为什么取名为鹅泉	0
为什么说电脑毕竟不能代替人脑	反装备武器有哪些	0
为什么海水无色而大海蓝色	为什么海水无色而大海蓝色	1
为什么毛冠鹿的头上没长角	为什么鸽子会成双成对	0
为什么犀牛鸟能和凶猛的大犀牛成为好朋友	为什么人的皮肤会有不同的颜色	0
为什么喝粥能滋补身体	世界四大水果是哪几种	0
为什么说世界上的东西都是由元素组成的	为么说世界上的东西都是由元素组成的	1
为什么有的人分辨不出颜色	为什么拨浪鼓的声音很好听	0
什么是黑客	为什么吃饭时看书不好	0
节食为什么不减肥反而增肥	为什么罂粟被称为有毒植物之王	0
飞机里新鲜空气哪里来	飞里新鲜空气哪里来	1
为什么青春期要多吃碘	为什青春期要多吃碘	1
红潮有什么危害	怎样煮蛋不爆	0
苗族有哪些礼仪及禁忌	苗族有哪礼仪及禁忌	1
为什么雨点有大有小	为什么雨点有大有小	1
为什么郑板桥能把河中的五彩石夹上来	为什么包拯被称为铁面包公	0
为什么说剪纸是一门中国的古老艺术	为什么说我国古代气象观测的水平很高	0
小学生不喜欢弹钢琴怎么办	为什么吐鲁番盆地被称为 火焰山	0
为什么有的鱼离开水不会死	为什么有的鱼离开水不会死	1
为什么猪流感让人闻之色变	青蛙的大嘴巴有什么用	0
为什么有的人会花粉过敏	为什么有的人会粉过敏	1
铅字是光用铅制造的吗	为什么司马光要用石头把缸砸破	0
为什么说四川省的铁树林是我国最大的铁树林	为什么说能在做游戏的过程中积累词汇	0
为什么法国被称为浪漫之国	为什么法国被称为浪漫之国	1
为什么湖水夏天浑浊，秋天清亮	为什么跳水有空中芭蕾之称	0
为什么天上的星星有的亮、有的暗	为什么天上的星星有的亮、有的暗	1
为什么太阳也会死亡	为什么说牡丹是花中之王	0
中国画为什么要用毛笔来画	国画为什么要用毛笔来画	1
为什么地球中心热,怎样测其温度	炒栗子的糖砂有什么功用	0
为什么说徐文长是个聪明的孩子	为什么做脑电图不会损伤大脑	0
为什么跑步比赛要逆时针跑	为什么说植物的种子是大力士	0
眼镜腿转动不灵怎么办	蜡染在哪些民族中流行	0
冥王星与其它各行星有什么不同	为什么跑步时不能用脚跟着地	0
为什么说秦始皇是中国第一个皇帝	古城为什么定名为无锡	0
为什么张九龄用鸽子送信	为什么张九用鸽子送信	1
为什么做事要细心	为什么美术又叫造型艺术	0
为什么只有老师没有看见	为什么只有老没有看见	1
为什么地球又叫蓝色的星球	为什么地球又蓝色的星球	1
为什么植物会啃石头	为什么泰国被称为大象之邦	0
为什么冬天暖房要开窗子	为什么哈萨克族姑娘的帽顶上插着猫头鹰羽毛	0
为什么鸟巢能吃呢	为什么鸟巢能呢	1
为什么花盆底部有个小洞	为什么花盆底部有个小	1
为什么我国北方春天会从天上下黄土	为什么我国北方春天会从天上下黄土	1
为什么这盆小菊花格外好看	清明节为什么是我国的传统节日	0
为什么响尾蛇的尾巴会发响	人在空中为什么不能再跳第二次	0
为什么夏天不能在中午给花浇水	为什么夏天不能在中午给花浇水	1
为什么有的飞机翼尖向上折起	为什么有飞机翼尖向上折起	1
飞船最佳发射窗口是怎样确定的	飞船最佳发射窗是怎样确定的	1
为什么苍蝇停在天花板上不会掉下来	水彩画和水粉画有什么区别	0
为什么青铜宝剑不会生锈	饺子或肉丸煮熟了为什么会浮起来	0
为什么济南又名泉城	为什么济南又名泉城	1
为什么不能用沙子去扑灭燃烧的炸药	为什不能用沙子去扑灭燃烧的炸药	1
什么是激光雷达	什么是激光雷达	1
为什么蚂蟥具有医学用途	为什么人会生病	0
无声手枪为什么会无声	为什么人的皮肤会有不同的颜色	0
密度计的刻度为什么是不均匀的	俄罗斯族有什么礼仪及禁忌	0
为什么小草长得特快、特别多	为什么他俩不去评理了	0
为什么狗在热天爱伸出舌头	为什狗在热天爱伸出舌头	1
为什么彩色照片时间久了会褪色	为什么彩色照片时间久了会褪色	1
为什么冰山被称为海洋杀手	为什么冰山被为海洋杀手	1
为什么闪电可怕而雷并不可怕呢	为什么闪电可怕而雷并不可怕呢	1
为什么演员跳踢踏舞时脚下会发出很响的声音	为什么喝粥能滋补身体	0
为什么射击后未爆的炮弹不许乱动	为什么人的一生要长两副牙齿	0
为什么早上能见到露水	为什么严寒的南北极也有植物安家落户	0
为什么天上会飘雪花	为什么天上会飘雪花	1
为什么三瓣石那么神秘	为什么三瓣石那神秘	1
为什么狼的眼睛会闪闪发光	为什么贝类身上要长壳	0
为什么大连的贝雕最好	为什么平平眼睛里的水满了	0
地球是怎样形成的	为什么可以利用超声波进行清洗	0
吃带鱼要去鳞吗	吃带鱼要鳞吗	1
为什么卫卫给老师厉害的回击	为什么孟母三次搬家	0
动物为什么不会迷失方向	为什么要把羊赶出来	0
收音机为什么会有杂音	八哥在水牛背上啄什么	0
为什么会出现日食和月食现象	拉祜族是怎样过扩塔节的	0
为什么我国古代的书刻在石头上	皮肤是怎样保持柔软和弹性的	0
为什么人能听到自己的回声	跳雷为什么会跳	0
应该怎样在现场急救溺水者	为什么说世界上的东西都是由元素组成的	0
为什么现代通信要利用卫星	为什么鸽子会成双成对	0
为什么飞鱼会飞	为什么吃豆腐最好配点海带	0
节食为什么不减肥反而增肥	节食为什么不减肥反而增肥	1
为什么岳飞会惨死风波亭	为什么岳飞会死风波亭	1
为什么豆子会生虫	为什么豆子会生虫	1
为什么孩子会得肠虫病	为什么孩子会得肠虫病	1
为什么植物的种子能无脚走遍天下	什么是步枪	0
为什么人可以听见声音	为什么人可以听声音	1
为什么豆子会生虫	为什么北极星会指方向	0
为什么电冰箱在停机后不能立刻起动	为什么电冰箱在停机后不能立刻起动	1
为什么幼儿常常爱告状	为什么幼儿常常告状	1
为什么有时候蜻蜓飞得很低	为什么有时候蜻蜓飞得很低	1
为什么肉汤凉得较开水慢	我爱你用英文怎么说	0
为什么油棕有世界油王的美称	为什么合理的膳食应当荤素搭配	0
为什么要适当地吃粗粮	!·壮族有些什么礼仪与禁忌	0
什么是气垫船	为什么要提倡平衡膳食	0
为什么海参会有分身术	为什么贝类身上要长壳	0
为什么会发生泥石流	脑袋大的人一定聪明吗	0
姜太公为何要用直钩钓鱼	姜太公为何要用直钩钓鱼	1
为什么法国被称为浪漫之国	什么是机器人	0
为什么鸟的歌声特别婉转动听	雪是怎样形成的	0
雨是怎样形成的	雨是怎形成的	1
海浪为什么迎岸而来	为什么投降举白旗	0
为什么雨点有大有小	什么是空间武器	0
为什么蛇的舌头总是伸出来	为什么蛇的舌头总是伸出来	1
为什么幼儿厌恶这位抽烟的阿姨	为什么幼儿厌恶这位抽烟的姨	1
为什么要淘汰氟里昂	松树为什么要流泪	0
为什么饭前饭后要休息一会儿	为什么崔杼要杀史官	0
命题作文为什么要认真审题	为什么说过多的装饰、打扮幼儿对其身心发展不利	0
为什么说并不一定要成为美术家才学习美术	什么是弹道导弹	0
动物能听懂音乐吗	动物能听音乐吗	1
什么是黑洞	什么是黑洞	1
为什么火山会喷发	为什么动物要有保护色	0
为什么蔬菜的味道不一样	为什么画画要画得满	0
为什么重阳节要登高	为什么要言之有理	0
为什么鄂温克族人的仓库里不放熊皮	为什么鄂温克族人的仓库里放熊皮	1
为什么有的植物间也有冤家对头	为什么脱下的衣服不要盖在被子上	0
为什么跑弯道的时候要内倾	什么跑弯道的时候要内倾	1
怎样用比较的方法审题	为什么有的树叶秋天会变红	0
海洋为什么会变成红色	海洋为什么会变成红色	1
为什么火焰山至今还有唐僧的拴马桩	为什么美国犹他州的天然拱比其他任何地方都多	0
为什么说能在做游戏的过程中积累词汇	为什么早晨和傍晚的太阳比中午的太阳大	0
运动后肌肉酸痛怎么办	为什么俄罗斯族人用面包和盐迎接客人	0
为什么壮族人民把歌节定为三月初三	为什么壮族人民把歌节定为三月初三	1
为什么山上的松树特别多	你了解气门芯吗	0
为什么蓄电池能蓄电	为什么蓄池能蓄电	1
为什么说埃及金字塔是古代文明史上的奇迹	为什么说他是聪明的小皇帝	0
为什么有淡水鱼和盐水鱼之分	为什么火箭炮能够布雷	0
为什么蓄电池能蓄电	为什么燕子低飞要下雨	0
为什么猪流感让人闻之色变	为什么猪流感让人闻之色变	1
蟋蟀的耳朵为什么长在脚上	蟋蟀的耳朵为什么长在脚	1
为什么脑子会越用越灵	什么脑子会越用越灵	1
为什么经常参加锻炼能使胖人消瘦，能使瘦弱的人变得壮实	为什么经常参加锻炼能使胖人消瘦，能使瘦弱的人变得壮实	1
为什么崔杼要杀史官	为什么崔杼要史官	1
为什么刘勰夜晚要到佛殿读书	为什么管这种熊又叫浣熊	0
为什么电灯泡会发光	为什么灯泡会发光	1
为什么豆腐和菠菜不能一起煮	为什么豆腐和菠菜不能一起煮	1
为什么海水是咸的	为什么萌萌拆半导体	0
为什么平平眼睛里的水满了	为什么叫它拳头木偶	0
电视图像为什么会出现重影	为什么叫姑嫂塔	0
为什么有的萝卜是黑心的	为什么星星、月亮不会掉下来	0
为什么叫歌声博物馆	为什么叫声博物馆	1
为什么网络有局域网、城域网和广域网之分	为什么网络有局域网、城域网和广域网之分	1
为什么潜艇里的人在水下不会憋死	为什么路温舒要把蒲草做成书本	0
为什么把天王星称做冷行星	为什么把天王星称做冷行	1
花为什么有各种颜色	为什么运动时应有意识地使呼吸变得深长和缓慢	0
为什么美国犹他州的天然拱比其他任何地方都多	山洞为什么有冷也有热	0
人为什么会上火	为什么冬季夜空中的星星比夏季少	0
为什么螃蟹要横着走	为什么坦克火炮在颠簸中能打得准	0
为什么用湿布抹冰箱的冰格会被粘着	为什么鸟有三个眼睑	0
为什么回音壁、三音石会传声	为什么有淡水鱼和盐水鱼之分	0
为什么幼儿经常自言自语	为什么死金鱼肚子向上翻	0
为什么B超能诊断疾病	为什么称老舍为人民艺术家	0
为什么核大战会产生核冬天	为什么核大会产生核冬天	1
微波炉是怎样把食物加热的	微波炉是怎样把食物加热的	1
为什么说齐白石是我国近代艺术大师	为什么叫木偶戏	0
为什么星星有不同的颜色	如何打开锈锁	0
如何防止油漆起皮	如何防止油漆起皮	1
为什么苹果皮上会有黑褐色干皮	为什么苹果皮上会有黑褐色干皮	1
为什么司马迁要忍辱著史记	为什么司马迁要忍辱著记	1
为什么摩擦过的尺子能吸小纸片	为什么摩擦过的尺子能吸小纸片	1
姜太公为何要用直钩钓鱼	姜太公为何要用直钩钓鱼	1
为什么药片要用温开水送服	为什么药片要用温开水送服	1
被疯狗咬伤怎么办	为什么练单双杠前要用镁粉擦手	0
为什么都夸鄂伦春族人心眼好	蒲松龄为什么能写出聊斋志异	0
为什么马要站着睡觉	为什么马要站着睡觉	1
笔杆上的小孔有什么功用	为什么小朋友容易被烫伤	0
为什么他能用手指分辨出糖、盐、碱	为什么他能用手指分辨出糖、盐、碱	1
为什么吃饭时说话会呛着	为什么吃饭时说话会呛着	1
为什么先看到闪电后听到雷声	为什么要理发	0
什么是微光电视	冥王星为什么是岩石型行星	0
为什么阴天时看不见太阳	为什么阴天时看不见太阳	1
为什么人要睡觉	为什么人要睡觉	1
为什么花也要睡觉	什么花也要睡觉	1
为什么鸽子会成双成对	为什么鸽子会成双成对	1
为什么称这棵连株榕树为最大的榕树	为什么称这棵连株榕树为最大的榕树	1
为什么磊磊的小飞机能变成机器人	为什么磊的小飞机能变成机器人	1
为什么小朋友不要多吃油炸的食物	为什么长吻鱼喜欢接吻	0
为什么奔跑时心脏会剧烈跳动	为什么看不见鸟洗澡，鸟也很干净	0
为什么指出自己缺点的朋友是好朋友	为什么指出自己缺点的朋友是好朋友	1
剥切葱时为什么会流泪	剥切葱时为什么会流泪	1
摩托车的二冲程和四冲程车有什么不同	为什么王安石要变法	0
为什么王毅小朋友画的机器人会打人	为什么要用手掂一掂	0
为什么蚯蚓是植物的好朋友	为什么上党人参会失踪	0
树叶为什么落下来	为什么水槽的下水管常做成弯曲的	0
为什么火星看上去是红色的	为什么火星看上去是红色的	1
内弹道学的定义及任务是什么	人为什么会发笑	0
为什么李贺让母亲担忧	为什么傈僳族要过刀竿节	0
火车头能做得轻便些吗	为什么生物武器令人感到恐怖	0
为什么孩子会得肠虫病	为什么子会得肠虫病	1
!!·你知道满族的礼节和禁忌吗	使用车用汽油要注意什么	0
为什么奥运会以五色环为标志	为什么奥运会以五色环为标志	1
人为什么要经常眨眼	人为什么要经眨眼	1
为什么下棋的人让王粲重新摆一遍棋子	为什么患肾炎的人仍能参加体育活动	0
为什么满族人院里都立着一根木杆	可以利用火山中心来获取能量吗	0
为什么树木能把人吃掉	商店里为什么有很多面镜子	0
为什么要用鼠标	为什么要鼠标	1
为什么中国画常把彩色的东西画成黑白的	为什么飞机要装红绿灯	0
水滴落沸油中会怎样	大蒜为什么能抑菌	0
为什么要用鼠标	为什么感冒后会流涕、鼻塞和发热	0
为什么老奶奶要磨铁棒槌	为什么蚊子喜欢穿深色衣服的人	0
为什么午睡前要散步	为什么午前要散步	1
人造卫星为什么会飞出地球	为什么睡觉要向右侧卧	0
为什么水族阿姨喜欢在衣裤上绣花边	普陀山为什么成为我国佛教名山之一	0
为什么叫虎门	古城为什么定名为无锡	0
为什么运动场都是南北向的	水彩画和水粉画有什么区别	0
冰为什么这么滑	为什么人会衰老	0
为什么有人听不懂古典音乐	为什有人听不懂古典音乐	1
为什么用流动的水洗手比用盆里水洗手效果要好	月亮上是什么样的	0
为什么竹子长得特别快	昆虫怎样吃东西	0
静电复印机是怎样工作的	静电复印机是怎样工作的	1
为什么东西扔上去总会落下来	为什么东西扔上去总会落下来	1
海南沉香是什么	哈尼族有什么礼仪及禁忌	0
为什么传说天上有条银河	为什么传说天上条银河	1
为什么内蒙古举行那达慕大会时那么热闹	为什么树叶在天冷的时候会掉下来	0
为什么星星、月亮不会掉下来	为什么星星、月亮不会掉下来	1
果树为什么有大小年	果树为什么有大小年	1
为什么阴天时看不见太阳	为什么阴天时看不见太	1
为什么主战坦克比普通坦克厉害	为什么运动时心跳加快，血压升高	0
为什么有的人会花粉过敏	为什么有的人会花粉过敏	1
为什么柿子有的甜、有的涩	为什么汉武帝要独尊儒术	0
为什么焦尾琴的尾部有烧焦的痕迹	为什么达斡尔族人爱往脸上抹黑	0
为什么徐湛之要让人先救弟弟	为什么韩德常老师是幼儿音乐教育家!·和幼儿作曲家	0
珊瑚为什么这样美	为什么桂林山水如此奇丽秀美	0
音乐为什么是人生活中的亲密伴侣	音乐为什么是人生活中的亲密伴侣	1
为什么植物会有形形色色的根	为什么植物会有形形色的根	1
为什么萌萌向爸爸要香烟盒	为什么许多动物在水面在墙面上如走平地	0
为什么月亮上很荒凉	为什么月亮上很凉	1
为什么吃捣烂的蒜好	剪羊毛可以不用剪刀吗	0
为什么梅花鹿身上的梅花会变	为什么同样的植物有的长得高，有的长得矮	0
什么是微光夜视仪	什么微光夜视仪	1
男人与女人的身体有什么差别	男人与女人的身体有什么差别	1
为什么被称为盐湖之家	为什么植物也有寄生虫	0
为什么在温度表上有下限而无上限呢	为什么网络可以入侵	0
为什么叫歌声博物馆	人在空中为什么不能再跳第二次	0
为什么隐形飞机会隐身术	为什么隐形飞机会隐身术	1
为什么王莽能篡汉	为什么韩德常老师是幼儿音乐教育家!·和幼儿作曲家	0
为什么不能吃死鳝鱼	为什么内蒙古举行那达慕大会时那么热闹	0
植物怎样抵御动物的侵害	为什么铅球的重量是7.257千克	0
为什么说螺是建筑奇才	为什么说螺是筑奇才	1
为什么虾片用油一炸就会胀大	什么是军用机器人	0
为什么一般人右手的力气比左手大	为什么一般人右的力气比左手大	1
为什么称王莲为 莲中之王	为什么核检查有不同的方法	0
为什么方方晒不黑	为什么雨从天空落到地上	0
为什么他能用手指分辨出糖、盐、碱	人为什么会得色肓症	0
电风扇能降低室温吗	为什么头发会脱落	0
为什么飞镖的尖鼻子先落地	为什飞镖的尖鼻子先落地	1
为什么冬天枯死的草，春天能发芽	为什么冬天枯死的草，春天能发芽	1
为什么有些建筑物样子特别怪	为什么有些建筑物样特别怪	1
为什么蓖麻籽不能吃	为什么蓖麻籽不能吃	1
为什么广州也叫羊城	为什么狗在热天爱伸出舌头	0
为什么患肾炎的人仍能参加体育活动	为什么切掉一只肾的人还能活着	0
为什么有的柑桔没有核	为什么说电脑毕竟不能代替人脑	0
为什么不能拿大伙儿的东西	为什么不能拿大伙儿的东西	1
为什么没煮熟的豆浆不能喝	为什么每个人的指纹不一样	0
为什么楼梯的台阶边缘有棱	为什么要给小草记功劳	0
为什么天上会飘雪花	为什么天上会飘雪花	1
为什么湖水夏天浑浊，秋天清亮	为什么中国有那么多种地方戏曲	0
为什么葡萄干里没有核	为什么葡萄干里没有核	1
为什么青春期要多吃碘	为什么青春期要多吃碘	1
用了为什么的句子，后面一定要加问号吗	干冰所产生的白雾是什么东西	0
为什么说画鬼容易画犬难	为什么人在剧烈活动后不能马上停下来	0
水开后摸壶底,烫手吗	水后摸壶底,烫手吗	1
为什么会出现一屋跨两国的情况	为什么铅球的重量是7.257千克	0
为什么毒蛇的肉也可以吃	为什么芳芳变了	0
为什么自己挠胳肢窝不会痒	为什么自己胳肢窝不会痒	1
为什么物体的重量会变	为什么王安石要变法	0
为什么熊猫的爪是六指儿	为什么熊猫的爪是六指儿	1
为什么肖思话决心改恶从善	斑马身上的花纹有什么用	0
为什么狮子大王收到的是一袋水	为什么拉祜族人都喜欢抽烟	0
为什么司马迁要忍辱著史记	为什么合理的膳食应当荤素搭配	0
宋词主要分为哪两大流派	宋词主要分为哪两大流派	1
月亮上是什么样的	月亮上是什么样的	1
为什么湿煤封火害处大	为什么湿煤封火害处大	1
为什么耳朵辨不清自己的音色	为什么耳朵辨不清自己的音色	1
为什么海水又咸又苦	为什么要用鼠标	0
为什么说铁树不容易开花	为什么说铁不容易开花	1
什么是地空导弹	植物为什么可以帮助人们寻找矿藏	0
为什么不让皇帝看起居注	为什么不让皇看起居注	1
为什么有的蘑菇不能吃	为什么说电脑毕竟不能代替人脑	0
为什么毒蛇和无毒蛇长得不一样	为么毒蛇和无毒蛇长得不一样	1
老年人怎样自我检查	什么叫干画法和湿画法	0
人在真空中会怎样	人在真空中会怎样	1
为什么丹麦被称为童话王国	为什么孔雀会开屏	0
什么树比钢还硬	什么树比钢还硬	1
纸放时间长了为什么变黄	纸放时间长了为什么变黄	1
为什么他俩不去评理了	为什么匡衡要凿壁借光	0
萤火虫为什么会一闪一闪的发光	为什么会出现开元盛世	0
什么是空间武器	为什么运动场上的草皮不怕踩	0
为什么桂林山水甲天下	为什么桂林山水甲天下	1
为什么维维含着泪又笑了	如何给纱窗安拉锁	0
为什么皮肤划破后血会自动凝结	宇航员在太空中怎样称体重	0
为什么有的人分辨不出颜色	为什么有的人分辨不出颜色	1
为什么赵高要指鹿为马	为什么小麻雀每天晚上飞来和杨宝做伴	0
为什么榕树能独木成林	为么榕树能独木成林	1
湿袜子为什么粘脚	景颇族有什么礼仪及禁忌	0
世界火炉指的是哪里	你知道声乐演唱有哪些形式吗	0
为什么艾滋病被称为20世纪的瘟疫	为什么金刚石最坚硬	0
为什么玲玲和鞋说话	为什么玲和鞋说话	1
为什么小海马不是海马爸爸生的	怎样使用漂白粉	0
怎样使用漂白粉	为什么小麻雀每天晚上飞来和杨宝做伴	0
为什么升旗时手里的绳子要向下拉	什么是疯牛病	0
为什么有些植物散发的气味令人感到清爽	为什么有些植物散发的气味令人感到清爽	1
火星上有生命吗	为什么抑制乙烯的生成和作用，可以贮藏保鲜	0
为什么说部首一般都是偏旁，而偏旁不一定是部首	为什么先看到闪电后听到雷声	0
为什么王育要卖身赔羊	为什么景颇族人每年要举行木脑盛会	0
为什么太阳月亮会跟着人走	怎样才能把这四样东西分开	0
为什么关电灯后已关的电视屏幕是白的	为什么关电灯后已关的电视屏幕是白的	1
为什么曹丕命令曹植在七步之内作诗一首	炒栗子的糖砂有什么功用	0
飞机为什么能飞	为什么说世界上的东西都是由元素组成的	0
为什么石灰岩洞中会生长着石笋和钟乳石	为什么饭前饭后要休息一会儿	0
为什么太阳给我们带来光和热	人是怎样看见物体的	0
为什么王莽能篡汉	如何给纱窗安拉锁	0
为什么说京剧是我们的国宝	什么是景泰蓝艺术	0
为什么不要躺着看书	为什么红脸的母鸡会生蛋	0
反装备武器有哪些	反装备武器哪些	1
莫斯塔尔城为什么出名	为什么说钟繇是楷书之祖	0
为什么雨后，天空中有时会有彩虹	拉祜族是怎样过扩塔节的	0
为什么古莲子为我国寿命最长的种子	神舟七号为什么选择夜间发射	0
为什么怪石被称为大象石	为什么怪石被称为大象石	1
为什么要淘汰氟里昂	为什么不用纯酒精消毒	0
夜晚的天空为什么是黑的	夜晚的天空为什么是黑的	1
为什么米仓口里流出许多好大米	冬季为什么用湿手接触铁器时会被粘住	0
为什么激光枪能百发百中	为什么激光枪能百发百中	1
什么是单音词、复音词	为什么受伤的水果会变黑	0
为什么看不见无花果的花	为什么文艺创作中允许虚构	0
珊瑚为什么这样美	珊瑚为么这样美	1
为什么笔是文房四宝中的一宝	为什么笔是文房四宝中的一宝	1
为什么指南针能指南	为什么广州也叫羊城	0
冷水和热水哪个沸腾快	为什么长白山是我国产人参最多的地方	0
海水会越来越咸吗	为什么超声波能除脏	0
为什么不是一个月看到一次日、月食	为什么不能拿大伙儿的东西	0
为什么说隋炀帝有功有过	为什么桂林山水如此奇丽秀美	0
影碟上常见镭射，究竟镭在哪儿，会损害人体吗	蜜蜂是怎样学习飞行的	0
为什么小调皮进入了角色	什么小调皮进入了角色	1
为什么我国是世界上最早栽培菊花的国家	为什么我国是世界上最早栽培菊花的国家	1
为什么提倡戒烟	为什么提倡戒烟	1
为什么说徐文长是个聪明的孩子	为什么说徐文长是个聪明的孩子	1
什么是微电子学	什是微电子学	1
为什么曹冲能知道大象的重量	为什么小朋友的胳膊容易脱臼	0
花粉长什么样呢	花粉长什么样呢	1
世界四大水果是哪几种	为什么能用瓶子奏出曲子来	0
为什么不要边看书报边吃饭	为什么不要边书报边吃饭	1
为什么芳芳变了	为什么火车上不能收听广播，却能打手机	0
为什么不要蒙头睡觉	为什么被蜘蛛吃过的小虫子会剩下空壳	0
为什么燃烧的蜡烛有时会冒黑烟	人为什么想不开	0
露是怎样形成的	运动的物体为什么都存在惯性	0
被疯狗咬伤怎么办	为什么光可窃听	0
为什么会发生八王之乱	为什么我国各民族都有传统乐器，你知道是什么吗	0
为什么饭前饭后要休息一会儿	为什么饭前饭后要休息一会儿	1
如何给纱窗安拉锁	如何给窗安拉锁	1
为什么把足球称为世界第一运动	为什么长吻鱼喜欢接吻	0
为什么颐和园内的铜牛是我国最大的铜牛	为什么勾践能够报仇雪耻	0
谁是最有影响的发明人	谁是最有影的发明人	1
为什么响尾蛇的尾巴会发响	为什响尾蛇的尾巴会发响	1
为什么纳西族人也过火把节	为什么纳西族人也过火把节	1
商店里为什么有很多面镜子	为什么哈尼族人特别注重礼貌	0
雾是怎样形成的	画中国画的纸为什么同画其他画的纸不一样	0
为什么要提倡少年儿童多写自己的生活和心灵世界	为什么要提倡少年儿童多写自己的生活和心灵世界	1
蒲松龄为什么能写出聊斋志异	为什么捕蝇草是最奇特的草	0
为什么颜料有透明不透明的区别	喇叭为什么变调了	0
为什么水不能燃烧	为什么不能燃烧	1
为什么满族人糊抹了油的窗纸	为什么浓甘油不宜搽脸	0
为什么纺锤树可以提供自来水	少女为什么会来月经	0
为什么说十五分钟是一刻钟	为什么人要睡觉	0
为什么会有独头蒜	为什么会有头蒜	1
鱼真的不睡觉吗	为什么射击时对不同距离的目标要定不同的表尺	0
春天的萝卜为什么会糠	为什么说不老松是我国最古老的一棵松树	0
为什么下雪时不冷，雪融时很冷	为什么要重视孩子的眼外伤	0
老鼠为什么乱啃东西	为什么山上的松树特别多	0
为什么法国被称为浪漫之国	为什么法国被称为浪漫之国	1
为什么皮肤晒黑是正常现象	为什么伤口愈合时会觉得痒	0
海鸥为什么总追着轮船飞	海鸥为什么总追着轮船飞	1
为什么有的幼儿有猜听别人说话的现象	为什么发豆芽要常换水	0
为什么电影中会有慢动作镜头	纳西族有哪些礼仪和禁忌	0
为什么南极的冰比北极多	为什么南极的冰比北多	1
为什么月亮上不能住人	为什么月亮上不能住人	1
为什么隐形飞机也会有克星	为什么会诞生太阳系	0
为什么花瓣都特别漂亮	为什花瓣都特别漂亮	1
世上真有桃花源吗	世上真有桃花吗	1
佤族有哪些礼仪和禁忌	为什么称我国是种植大豆最早的国家	0
喇叭为什么变调了	喇叭为什么变调	1
为什么荷花出淤泥而不染	为什么荷花出淤而不染	1
为什么要建国际空间站	为什么说毛毛虫是杨树的花	0
为什么傣族人喜欢住竹楼	为什么傣族人喜欢住竹楼	1
为什么景颇族人吃饭用叶子当碗碟	为什景颇族人吃饭用叶子当碗碟	1
为什么水面上的汽油是彩色的	为什么水面上的汽油是彩色的	1
海鸥为什么追逐舰船	海鸥为么追逐舰船	1
为什么要修筑万里长城	为什么彩电对天线的要求特别高	0
为什么治疗肠虫病要用安乐士	什么是猎潜艇	0
为什么飞镖的尖鼻子先落地	为什么运动场都是南北向的	0
为什么叫神光山	为什么叫神光山	1
为什么植物也有寄生虫	怎样使鸡肉更鲜美	0
生活常识灭火器为什么能把火扑灭	为什么冬天枯死的草，春天能发芽	0
为什么海水的浮力大	为什么犀牛鸟能和凶猛的大犀牛成为好朋友	0
为什么看不见无花果的花	为什么摩擦过的尺子能吸小纸片	0
为什么冰雹出现在暖季	什么冰雹出现在暖季	1
你知道十二部对歌是哪个民族的情歌吗	你知道十二部对歌是哪个民的情歌吗	1
什么是高射机枪	为什么豆子会生虫	0
怎样去菜馅中的水分	怎样去菜馅中的水分	1
脑袋大的人一定聪明吗	为什么会形成东非大裂谷	0
为什么要修筑万里长城	为什么说美并不等于漂亮	0
为什么火箭顶端要安装一根天线样的钢针	什么火箭顶端要安装一根天线样的钢针	1
为什么电子琴能模拟其他乐器的声音	为什么电子琴能模拟其他乐器的声音	1
为什么地球在转，而我们却感觉不到	高空的气温为什么低	0
为什么说吴昌硕是开启一代画风的画家	为什么说吴昌硕是开启一代画的画家	1
纸是怎样生产出来的	为什么月亮不会发光却是明亮的	0
为什么合理的膳食应当荤素搭配	为什么中国的筷子驰名世界	0
为什么米粥加盐会变稠，加糖会变稀	为什么每天锻炼也消耗不完人的体力	0
·!!·什么是戏曲行当的净	·!!·什么是戏曲行当的净	1
为什么叫虎门	为什么叫虎门	1
甘遂为什么开绿花	为什么吐鲁番盆地被称为 火焰山	0
这里为什么有世界最大的鳄鱼动物园	这里为什么有世界最大的鱼动物园	1
云是怎样形成的	什么是反卫星武器	0
为什么看鱼鳞能知道鱼的年龄	为什么有时会收到乱码的电子邮件	0
带沙袋进行体育锻炼会得关节炎吗	带沙袋进行体育锻炼会得关炎吗	1
地磁场变化吗,它变化会有什么影响	为什么王祥吃东西，王览总要先尝一口	0
为什么说过多的装饰、打扮幼儿对其身心发展不利	为什么冰川会流动	0
你知道土族有哪些礼仪和禁忌吗	你知道土族有哪礼仪和禁忌吗	1
什么是ABS刹车防抱死系统	为什么降落伞能使伞兵准确降落	0
为什么叶子两面的颜色深浅不同	为什么有些城市的电话号码特别长	0
为什么薄薄的圆纸片能立起来	为什么薄薄的纸片能立起来	1
为什么说铁树不容易开花	额不里海滩为什么是旅游的好地方	0
为什么杂技演员表演水流星时，水不会洒出来	为什么杂技演员表演水流星时，水不会洒出来	1
你知道黎族有哪些礼仪和禁忌	你知道黎族有哪些礼仪和禁忌	1
为什么聪明的贝贝不会区分各种几何图形	为什么聪明的贝贝不会区分各几何图形	1
为什么鸟类有偷东西的嗜好	为什么武则天会留下无字碑	0
为什么不能滥用抗生素	山谷的风是怎样形成的	0
为什么八月十五吃月饼	为什么八月十五月饼	1
为什么说蚂蚁可以用来治病	为什么铝不容易生锈	0
怎样看多幅图写作文	怎样看幅图写作文	1
为什么蔡和森挨饿也要读书	为什么叫姐妹山	0
牛蛙的肤色为什么会改变	为什么太阳给我们带来光和热	0
为什么蟒河那么迷人	你知道十二部对歌是哪个民族的情歌吗	0
为什么澳大利亚被称为骑在羊背上的国家	为什么澳大利亚被称为骑在羊背上的国家	1
什么是驱逐舰	为什么说有办法能把海水里的盐去掉	0
哈尼族有什么礼仪及禁忌	为什么说晨晨最勇敢	0
剥切葱时为什么会流泪	卫星是怎样发射的	0
为什么把有的乐队叫交响乐队	为什么把有的乐队叫交响乐队	1
音乐为什么是人生活中的亲密伴侣	为什么说台湾是祖国的宝岛	0
为什么体操运动员要在手上涂白色粉末	为什么体操运动员要手上涂白色粉末	1
为什么吃菠萝时蘸盐水	怎样才能续写出合情合理的情节	0
为什么秦始皇要焚书坑儒	维吾尔族有什么礼仪、禁忌	0
排球运动是怎样产生的	为什么计算机的时钟在断电时仍能正常工作	0
为什么基诺族人喜爱竹子	为什么基诺族人喜爱竹子	1
为什么电冰箱在停机后不能立刻起动	为什么电冰箱在机后不能立刻起动	1
为什么用硬笔书写也称书法	为什么头发会脱落	0
中国古代有街道树吗	中国代有街道树吗	1
为什么青少年要预防肥胖	为什么青少年预防肥胖	1
为什么说画人难画手	为什么说画人难手	1
维吾尔族有什么礼仪、禁忌	怎样使肥皂一物多用	0
你知道门巴族有哪些礼仪及禁忌吗	老年人怎样自我检查	0
什么是和平号空间站	什么是和平号空间站	1
为什么夏天会下冰雹	为什么喝粥能滋补身体	0
为什么吐鲁番盆地被称为 火焰山	为什么银杏树有活化石之称	0
为什么舌头能辨别味道	为什么舌能辨别味道	1
为什么天上会出现新星	为什么天上会出现新星	1
自行车是怎样加速运动和刹车的	自行车是怎样加速运动和刹车的	1
为什么海带不会开花结籽也能繁殖	冬天树叶落地时为什么一般正面对地	0
为什么去畲族人家进门有三道关	为什么花瓣都特别漂亮	0
为什么植物会啃石头	为什么植会啃石头	1
为什么无声手枪是无声的	为什么文艺创作中允许虚构	0
为什么计算机也会生病	为什么计算机也会生病	1
为什么胡杨能在沙漠中生存	为什么胡杨能在沙漠中生存	1
为什么豆腐和菠菜不能一起煮	为什么豆腐和菠菜不一起煮	1
为什么儿童团长王璞能抓住特务	为什么法国被称为浪漫之国	0
地球同步轨道就是地球静止轨道吗	地球同步轨道就是地球静止轨道吗	1
为什么月亮会从云里钻来钻去	为什么月亮会从云里钻来钻去	1
为什么潜艇里的人在水下不会憋死	为什么火山会爆发	0
为什么叫音乐电话	金粉和银粉是用金子和银子做的吗	0
为什么旋转球不走直线	为什么旋转球不走直线	1
为什么盲鳗可以吃比它大得多的鱼	为什么盲鳗可以吃比它大得多的鱼	1
为什么说中国的书法和绘画是一对兄弟	为什么只有老师没有看见	0
为什么会发生地震	为什么切掉一只肾的人还能活着	0
为什么不要把桔子皮扔掉	什么是猎雷舰	0
火炮为什么要装注油嘴	火炮为什么要装注油嘴	1
怎样保存腻子	怎样保腻子	1
为什么传统办法可以对付卫星侦察	为什么传统办法可以付卫星侦察	1
为什么航母上的官兵要穿上五颜六色的军服	为什么在飞机上禁止使用移动电话	0
为什么红比拉鱼被称为危险动物	为什么焦尾琴的尾部有烧焦的痕迹	0
为什么有时候蜻蜓飞得很低	为什么中国的筷子驰名世界	0
为什么一星期有七天	伊斯兰教为什么要过圣纪节	0
为什么丁丁知道排队了	为什么树木要修剪	0
老年人怎样自我检查	为什么鄂温克族人喜欢驯鹿	0
为什么提倡戒烟	为什么老师一下子就知道了来客是谁	0
为什么合理的膳食应当荤素搭配	为什么蛇能在黑夜里捕捉到田鼠	0
为什么蜻蜓要点水	为什么跑步后特别渴，老师却不让我们马上喝个够	0
莫斯塔尔城为什么出名	莫斯塔尔城为什么出名	1
如何让蚊香自动熄灭	如何让蚊香自动熄灭	1
为什么说美洲豹比狮、虎的本领都大	为什么说美洲豹狮、虎的本领都大	1
为什么说喜马拉雅山是从海里升起来的	为什么说马拉雅山是从海里升起来的	1
大海中为什么也有四季变化	拉祜族是怎样过扩塔节的	0
为什么海蜇会螫人	为什么海蜇会螫人	1
为什么毕达哥拉斯定理又称为勾股定理	为什么植物也有寄生虫	0
为什么不要生吃杏的种仁	为什么不要吃杏的种仁	1
为什么湖水夏天浑浊，秋天清亮	为什么湖夏天浑浊，秋天清亮	1
为什么苹果皮上会有黑褐色干皮	为什么称作一勺之多泉	0
中国画为什么有很多画线条的方法	中国画为什么有很多画线条的方法	1
太空育种的原理是什么	为什么眼镜蛇发怒时脖子会变粗	0
为什么说单纯学习技法并不能真正学好美术	为什么叫蜡染布	0
为什么岳飞会惨死风波亭	为什么壮壮小朋友最欣赏柿子儿子	0
为什么说音乐能寓教于乐	为什么薄薄的圆纸片能立起来	0
为什么乌龟身上会出汗	为什么乌龟身上会出汗	1
为什么叶子两面的颜色深浅不同	为什么子两面的颜色深浅不同	1
为什么蓄电池能蓄电	为什么蓄电池能蓄电	1
为什么说海洋和陆地是会变化的	为什么画人的时候要讲究比例	0
为什么要用Email	冰川是如何形成的	0
为什么淳于意流着眼泪，夸赞自己的女儿	为什么要用计算机售票	0
拔牙后为什么要及时镶牙	樱花为什么被称为日本的国花	0
红糖结块怎么办	红糖结块怎么办	1
什么是褒义词	什么是褒义词	1
V字手势的来源是什么	为什么王毅小朋友画的机器人会打人	0
什么是巡洋舰	什么是巡洋舰	1
为什么明明是画却要叫素描	为什么说猩猩最聪明	0
为什么豆腐和菠菜不能一起煮	为什么豆腐和菠菜不能一煮	1
为什么海参会有分身术	什么是侗族芦笙舞	0
为什么月经期不能游泳	为什么月经期不能游泳	1
为什么蚊子喜欢穿深色衣服的人	为什么商品要采用条形码	0
为什么韩德常老师是幼儿音乐教育家!·和幼儿作曲家	为什么说太阳是太阳系的家长	0
为什么宝石是五颜六色的	为什么燃烧的蜡烛有时会冒黑烟	0
有些坦克炮的抽烟装置为什么偏置	什么人适合吃人参	0
为什么王育要卖身赔羊	为什么王育要卖身赔羊	1
为什么火箭和飞机的头部是尖的	为什么小儿易出现肠套叠	0
为什么毒蛇的肉也可以吃	为什么少年也有可能长白发	0
为什么迫击炮可以打到山后目标	为什么要使用不同的谱号	0
红潮有什么危害	红潮有什么危害	1
为什么说毛毛虫是杨树的花	为什说毛毛虫是杨树的花	1
不同的树过冬方法相同吗	不同的树过冬方法相同吗	1
为什么饮绿茶能消除口臭	为什么在树枝上睡觉的鸟不会掉下来	0
为什么维维含着泪又笑了	为什么有的幼儿在陌生人和集体面前表现得很胆怵	0
为什么说能在做游戏的过程中积累词汇	生长着的花、果香味为什么与采摘下的不同	0
为什么房顶上能长出小树小草	鄂伦春族过春节与赫哲族有什么不同	0
为什么火焰山至今还有唐僧的拴马桩	为什么火焰山至还有唐僧的拴马桩	1
蟋蟀的耳朵为什么长在脚上	水开后摸壶底,烫手吗	0
为什么电冰箱有时嗡嗡响	为什么电视机只能收看当地电视台的节目	0
为什么短跑运动员经常拉伤大腿后面的肌肉	为什么短跑运动员经常拉伤大腿后面的肌肉	1
为什么人们把血液看成是生命	大雪后为什么很寂静	0
雷声为什么隆隆作响很长时间	雷声为什么隆作响很长时间	1
为什么鸽子会成双成对	为什么鱼能在水里游来游去	0
游泳时耳朵进了水怎么办	游泳时耳朵进水怎么办	1
为什么大禹治水的故事至今流传	商店里为什么有很多面镜子	0
为什么要给小草记功劳	什么要给小草记功劳	1
如何给纱窗安拉锁	如何给纱窗安拉锁	1
谁是最有影响的发明人	苗族有哪些礼仪及禁忌	0
用了为什么的句子，后面一定要加问号吗	为什么雨后空气特别好	0
为什么小飞虫总爱在灯下飞来飞去	为什么小飞虫总爱灯下飞来飞去	1
为什么他能揭开细腰蜂变化的秘密	为什么登山被称为勇敢者的运动	0
为什么猴子会演戏	为什么生物武器令人感到恐怖	0
什么叫一次能源和二次能源	雾是怎样形成的	0
为什么青少年要预防肥胖	怎样用可乐瓶做小姑娘的裙子	0
为什么在飞机上禁止使用移动电话	为什么在飞机上禁止使用移动电话	1
为什么说太阳是太阳系的家长	为什么说太阳是太阳系的家长	1
为什么吸尘器可以吸走灰尘	为什么说让婴儿多爬有许多好处	0
为什么哈萨克族姑娘的帽顶上插着猫头鹰羽毛	为什么哈萨克族姑娘的帽顶上插着猫头鹰羽毛	1
为什么独龙族人都吃大锅饭	为什么蹲久了站起来就会头晕眼花	0
为什么同一个玉米棒上会有不同颜色的粒	为什么一个玉米棒上会有不同颜色的粒	1
什么是贬义词	什是贬义词	1
新买来的胶卷为什么外面都包着黑纸	新买来的胶卷为什么外面都包黑纸	1
为什么用硬笔书写也称书法	怎样才能把这四样东西分开	0
什么是外来词	什么是外词	1
为什么练单双杠前要用镁粉擦手	怎样用比较的方法审题	0
为什么做事要细心	暖水瓶为什么能保温	0
水滴落沸油中会怎样	水滴落沸油中会怎样	1
为什么鲸不是鱼	蠡园为什么是中外游人迷恋的地方	0
莫斯塔尔城为什么出名	为什么卫卫给老师厉害的回击	0
为什么幼儿特别愿意和玩具小动物说话	宇宙空间有温度吗，是多少	0
为什么粥烧开了会溢出来	为什么冬天会有霜	0
为什么戴胜鸟又叫臭姑鸪	为什么说美并不等于漂亮	0
为什么幼儿会出现不是自己错也承认错的现象	为什么被称为盐湖之家	0
为什么北京有那么多有名和好玩的地方	为什么北京有那么多有名和好玩的地方	1
为什么吃饭前后不要做剧烈活动	为什么运动后不想立即吃饭	0
为什么肉汤凉得较开水慢	为什么说太阳离我们很远很远	0
为什么磊磊的小飞机能变成机器人	为什么香蕉里看不到种子	0
给电池充电要先放掉剩余的电，对吗	为什么冲浪运动员能站在水面上而不被大浪冲走	0
为什么水果不都是甜的	为什么月亮有月相变化	0
为什么苗族人要过龙船节	为什么会出现战国七雄	0
为什么桂林山水甲天下	什么是宇宙尘？它们从哪里来	0
为什么高速飞行需设置特殊的跳伞装置	为什么速飞行需设置特殊的跳伞装置	1
为什么徐湛之要让人先救弟弟	为什么廷廷认不出那只泥猫了	0
为什么叫蜡染布	为什么叫蜡染布	1
为什么精神紧张时手心会出汗	为什么关电灯后已关的电视屏幕是白的	0
干冰所产生的白雾是什么东西	干冰所产生的白雾是什么东西	1
美术的含义是什么	为什么要提倡说普通话	0
为什么潜艇里的人在水下不会憋死	为什么潜艇里的人在水下不会憋死	1
为什么看不见鸟洗澡，鸟也很干净	为什么看不见鸟洗，鸟也很干净	1
为什么话剧演员要必修音乐课	太阳为什么会有太阳黑子	0
为什么说地球里面不是厚厚的土	为什么说地球里面不是厚的土	1
为什么自行车比赛选手要走之字形路线	用四氯化碳灭火要注意什么	0
为什么说我国的地形分布是有规律的	为什么说我国的地形分布是有规律的	1
为什么在黑暗中看不见东西	男人与女人的身体有什么差别	0
纳米材料有什么应用	纳米材料有什么应用	1
蠡园为什么是中外游人迷恋的地方	为什么紧张运动后,肌肉会抽搐	0
为什么他俩不去评理了	为什么说学音乐能使人聪明	0
为什么说小行星是恐龙灭绝的元凶	为什么高速飞行需设置特殊的跳伞装置	0
为什么运动前要做准备活动	为什么要让小朋友尽早学会用筷子	0
为什么在野外也能辨别出方向	什么在野外也能辨别出方向	1
为什么地球上有那么多山	什么地球上有那么多山	1
常规潜艇为什么不能长时间在水下	常规潜艇为什么不能长时间在水下	1
为什么空气并不空	为什么把花的叶子摘了，花就死了	0
为什么刘勰夜晚要到佛殿读书	为什么刘勰夜晚要到佛读书	1
为什么有的坦克能在陆地和水中行使	为什么青少年不宜经常开夜车	0
植物为什么也需要睡大觉	电影院的楼上为什么要比楼下暖和	0
为什么鄂温克族人的仓库里不放熊皮	为什么鄂温克族人的仓库里不放熊皮	1
为什么说巨人岬是大自然的杰作	为什么说巨人岬是大自然的杰	1
为什么云南大理最大的集市叫三月街	为什么云南大理最大的集市叫月街	1
鹞式战斗机为什么能垂直起降	为什么领港鱼不怕大鲨鱼	0
为什么亚当桥不同于一般的桥	为什么蜂窝都是六角形的	0
大雪后为什么很寂静	大雪为什么很寂静	1
为什么要建国际空间站	为什么千岁兰也可以称为沙漠章鱼	0
阿昌族为什么要过尝新节、撒种节及耍白象	阿昌族为什么要过尝新节、撒节及耍白象	1
为什么上党人参会失踪	为什么上党人参会失踪	1
宇宙空间有温度吗，是多少	水杉是名副其实的世界爷吗	0
为什么大连的贝雕最好	为什么大连的贝雕最好	1
为什么王羲之被奉为书圣	为什么太监要往蜜坛子里放老鼠屎	0
为什么做眼保健操能预防近视	为什么荆轲刺秦王没有成功	0
为什么刀钝了，磨磨就能快	游泳时耳朵进了水怎么办	0
为什么螃蟹要吐沫	为什么螃蟹要吐沫	1
为什么月亮不会发光却是明亮的	为什么数码相机不使用胶卷	0
画中国画的纸为什么同画其他画的纸不一样	画中国画的纸为什么同画其他画的纸一样	1
为什么电灯泡会发光	为什么电灯会发光	1
为什么水上飞机能在海上起降	为什水上飞机能在海上起降	1
为什么物体的重量会变	为什么物体的重量会变	1
斑马身上的花纹有什么用	斑马身上花纹有什么用	1
怎样旋开玻璃瓶上太紧的铁盖	为什么中国画常把彩色的东西画成黑白的	0
为什么哈雷彗星能准时回归	为什么苗族有四月八这个节日	0
为什么有些植物散发的气味令人感到清爽	为什么要使用信用卡	0
为什么物体的重量会变	为什么画画时会用眼睛比会用手更重要	0
为什么冷饮不可多吃	为什么天上的星星数不清	0
为什么流星会从天上掉下来	为什么主战坦克比普通坦克厉害	0
为什么荆轲刺秦王没有成功	为什么荆轲秦王没有成功	1
为什么彩虹的七色顺序总是不变	为什么彩虹的七色顺序总是不变	1
为什么楼房外边的墙上要安装管子	为什么楼房外边的墙上要安装管子	1
无声手枪为什么会无声	无声手枪为什么会无声	1
为什么海豹喜欢吃石块	佛手瓜的种子为什么不能与瓜分开	0
为什么北京有那么多有名和好玩的地方	为什么说太阳离我们很远很远	0
靖康之变是怎样发生的	什么是转轮手枪	0
为什么鱼在冰冷的水里不怕冷	为什么地球会绕轴自转	0
青蛙的大嘴巴有什么用	人造卫星为什么会飞出地球	0
你知道声乐演唱有哪些形式吗	为什么吃菠萝时蘸盐水	0
为什么刀钝了，磨磨就能快	为什么变压器能改变电压的高低	0
什么是超声显微镜	什么是声显微镜	1
怎样除去镜片上的水雾	怎样去镜片上的水雾	1
为什么人有头皮屑	洒水车上的水桶为什么不做成方的或圆形的	0
为什么传统办法可以对付卫星侦察	为什么发豆芽要常换水	0
地球同步轨道就是地球静止轨道吗	为什么说药补不如食补	0
狐为什么会给人留下诡计多端的印象	为什么鱼会跳出水面	0
为什么火箭要垂直发射	内弹道学的定义及任务是什么	0
为什么夏天星星比冬天多	为什么夏天星星比冬天	1
为什么会发生918事变	为什么会发生918事变	1
为什么变色龙善于变色	为什么郑板桥能把河中的五彩石夹上来	0
为什么商品要采用条形码	为什商品要采用条形码	1
为什么嗅觉有时会失灵	为什么嗅觉有时会失灵	1
为什么泰国被称为大象之邦	为什么泰国被称为大象之邦	1
海水会越来越咸吗	为什么青少年不宜经常开夜车	0
为什么秦始皇被称为千古第一帝	为什么隐形飞机也会有克星	0
为什么电视剧和电影要有导演	为什么电视剧和电影要有导演	1
为什么小明选择了雪	为什么叫天然时钟	0
清明节为什么是我国的传统节日	为什么意大利被称为旅游之国	0
为什么叫它植树鸟	为什么兵马俑坑是名胜古迹	0
红糖结块怎么办	为什么血能在人体中流动	0
为什么有人弹钢琴老爱出错	为什么有人弹钢老爱出错	1
火车头能做得轻便些吗	为什么地球内部可以分成许多圈层	0
为什么在野外也能辨别出方向	为什么在野外也能辨别出方向	1
高空的气温为什么低	高空的气温为么低	1
为什么天上的星星数不清	为什么天上的星星数不清	1
流星雨怎么形成的	为什么奥运会有传递和点燃圣火的仪式	0
为什么说我国是茶叶的故乡	为什说我国是茶叶的故乡	1
剪了指甲为什么还会长	为什么跳水有空中芭蕾之称	0
为什么车胤要囊萤读书	为什么有时枪会胀膛炸膛	0
为什么海王星的环呈短弧状	为什么演员跳踢踏舞时脚下会发出很响的声音	0
为什么不能给花浇凉开水	甘遂为什么开绿花	0
什么是疯牛病	为什么淝水之战中东晋军能以少胜多	0
为什么流星会从天上掉下来	为什么流星会从天上掉下来	1
为什么很快排除了飞机干扰	为什么先看到闪后听到雷	0
为什么晚上捕鱼用灯能引诱鱼群	为什么晚上捕鱼用能引诱鱼群	1
为什么说学音乐能使人聪明	为什么学音乐能使人聪明	1
为什么蚂蚁不上床了	为什么得了蛔虫病会肚子疼	0
为什么沙漠里会有绿洲	为什沙漠里会有绿洲	1
为什么荷花出淤泥而不染	为什么跳水有空中芭蕾之称	0
为什么人人要有副整齐的牙齿	海鸥为什么总追着轮船飞	0
用四氯化碳灭火要注意什么	用四氯化碳灭要注意什么	1
为什么会爆发第二次世界大战	有头上长角的鱼吗	0
为什么中医也讲阴阳五行	为什么弹壳底火被击针一击即发火	0
为什么看不见无花果的花	为什么不见无花果的花	1
为什么吃饭时看书不好	为什么吃饭时看书不好	1
为什么从冷气间走出来，眼镜会模糊一片	宋词主要分为哪两大流派	0
为什么梅花鹿身上的梅花会变	为什么计算机能思考	0
为什么计算机会产生千年虫问题	为什么计算机会产生千年虫问题	1
杂技演员为什么能用牙齿挂着一个人	杂技演员为什么能用牙齿挂一个人	1
为什么苗族有四月八这个节日	潜水艇为什么能上浮和下沉	0
为什么常绿树能变成落叶树	为什么常绿树能变成落叶树	1
什么人适合吃人参	什么人适合吃人参	1
饺子或肉丸煮熟了为什么会浮起来	饺子或肉丸熟了为什么会浮起来	1
为什么铁特别容易生锈	为什么不能拿大伙儿的东西	0
为什么有些磺胺类药要与小苏打合用	为什么我国北方海岸大多比较平直，南方海岸比较弯曲	0
为什么纸盒做的小火车能拐弯	为么纸盒做的小火车能拐弯	1
为什么月经期不能游泳	为什么经期不能游泳	1
为什么别府温泉首屈一指	为什么白天看不见星星	0
宇宙是怎样形成的	宇宙是怎样形的	1
为什么碳钟可以测定古文物的年龄	为什么岳柱对名画提出批评	0
乙醇汽油和普通汽油有什么不同	布依族的六月六、四月八是怎么回事	0
为什么小明选择了雪	为什么冰块能漂在水面上	0
为什么水果不都是甜的	什么是黑客	0
为什么董仲舒要提出罢黜百家，独尊儒术	为什么说让婴儿多爬有许多好处	0
为什么战国时期会形成百家争鸣的局面	为什么战国时期会形成百家争鸣的局面	1
咸蛋的蛋黄为什么会出油	为什么说让婴儿多爬有许多好处	0
为什么肉汤凉得较开水慢	为什么肉汤凉得较开水慢	1
为什么夏天不能在中午给花浇水	为什么夏天不能在午给花浇水	1
为什么称作一勺之多泉	为什么称作一勺之多泉	1
怎样更准确地审清题意	·!!·为什么方承观立志苦学	0
桌面开裂怎么办	桌面开裂么办	1
为什么吕后会乱政	为什么云南土林给人奇特的感觉	0
为什么外国影片中的人物也说的是中国话	为什么外国影片中的人物也说的是中国话	1
墙皮为什么会出汗	墙皮为什么会出汗	1
为什么汉武帝要独尊儒术	为什么汉武帝要独尊儒术	1
为什么人的皮肤会有不同的颜色	中国画为什么有工笔画和写意画之分	0
藏族的雪顿节是怎么回事	为什么画人的时候要讲究比例	0
日月平升是怎么回事	为什么老师一下子就知道了来客是谁	0
你知道傈僳族有哪些礼仪和禁忌吗	为什么吃豆腐最好配点海带	0
为什么路温舒要把蒲草做成书本	为什么磊磊的小飞机能变成机器人	0
为什么说并不一定要成为美术家才学习美术	为什么说并不一定要成为美术家才学习美术	1
为什么天空中会出现流星	为什么天空中会出现流星	1
为什么短跑运动员要下蹲起跑	敌人为什么要杀害罗志群和邓金娣	0
为什么铅笔伸进水就像是断了	为什么说奥地利是音乐王国	0
为什么水面上的汽油是彩色的	为什么叫姑嫂塔	0
电视机为什么要罩上布套	电视机为什么要罩上布套	1
为什么花也要睡觉	什么是全球定位系统	0
排球运动是怎样产生的	排运动是怎样产生的	1
为什么提倡戒烟	什么是激光雷达	0
为什么给鸡戴红色眼镜可以多产蛋	为什么给鸡戴红色眼镜可以多产	1
为什么称李白为诗仙	为什么鼻子贴在花上闻花香不好	0
地磁场变化吗,它变化会有什么影响	为什么说画人难画手	0
纳西族有哪些礼仪和禁忌	纳西族有哪些礼仪和禁忌	1
流星雨怎么形成的	什么刘备要三顾茅庐	0
为什么称这棵连株榕树为最大的榕树	为什么称这棵株榕树为最大的榕树	1
为什么南海的小岛数也数不清	为什么南海的小岛数也数不清	1
怎样培养你的音乐细胞	为什么海边的白天和黑夜温度变化不大呢	0
为什么大、小兴安岭及完达山是我国最大的森林基地	为什么鄂温克族人喜欢驯鹿	0
为什么鳄鱼不属于鱼	为什么鳄鱼不属于鱼	1
为什么半可燃药筒能被广泛应用	海菊花为什么不是花	0
为什么热水瓶能保温	为什么不能拿大伙儿的东西	0
·!!·什么是戏曲行当的净	什么是巡洋舰	0
为什么火车的车窗有两层玻璃	中国古代有街道树吗	0
为什么病毒可致人于死地	这里为什么有世界最大的鳄鱼动物园	0
为什么彗星都拖条尾巴	为什么彗星都拖条尾巴	1
为什么计算机的时钟在断电时仍能正常工作	为什么舌头能辨别味道	0
为什么张大千被誉为当代第一大画家	为什么张大千被誉为当第一大画家	1
为什么要从小预防近视眼	为什么要从小预防近视眼	1
为什么聪明的贝贝不会区分各种几何图形	为什么聪明的贝贝不会区分各种几何图形	1
在月经期做劈叉、倒立等活动对身体有害吗	为什么老奶奶要磨铁棒槌	0
动物能听懂音乐吗	叶片为什么会吐水	0
为什么太阳给我们带来光和热	为什么山洞有冷暖之分	0
什么是弹道导弹	如何把洗衣机改成洗碗机	0
树叶为什么落下来	树叶为么落下来	1
为什么补色法能显示景物的立体感	为什么补色法能显示景的立体感	1
为什么说大自然里有音乐	为什么会有鼓，鼓有什么用	0
什么是计算机病毒武器	为什么蟋蟀会用翅膀唱歌	0
为什么男子会长胡子	为什么男子会长胡子	1
什么是步枪	为什么雷雨时，先看到闪电，后听到雷声	0
为什么人们把血液看成是生命	为什么子弹在飞行时旋转	0
为什么岳柱对名画提出批评	为什么一条电话线路上可以通多路电话	0
为什么韦嗣立的母亲会受到感动	为什么张溥把自己的书房叫作七录书斋	0
铁饼和标枪运动是怎样产生的	为什么猴岛成为旅游中的一个热点	0
拔河比赛只是比力气吗	为什么交响乐不容易听懂	0
为什么地球会绕轴自转	为什么伙伴们要嘲笑陈胜	0
为什么预警机要背个大圆盘	为什么预警机要背个大圆	1
冥王星与其它各行星有什么不同	为什么幼儿往往用错一些有关时间的语词	0
为什么红脸的母鸡会生蛋	为什么荷叶遇雨结水珠	0
为什么天上的星星有的亮、有的暗	楔式炮闩体为什么做成棱柱形	0
为什么自行车骑得越慢就越容易倒	怀孕后为什么要少吃米饭	0
狂犬病是怎么回事	为什么有时枪会胀膛炸膛	0
为什么米芾的字写得那样好	为什么米芾的字写那样好	1
阅读中碰到不懂的文言词汇该怎么办	阅读中碰到不懂的文言词汇该怎么办	1
为什么徐光启要把棉株尖顶上的嫩芽掐断	为么徐光启要把棉株尖顶上的嫩芽掐断	1
为什么要提倡平衡膳食	怎样看多幅图写作文	0
美国的导弹防御计划是怎样的	为什么蛤、蚌里能产珍珠	0
为什么磕头虫会磕头	为什么说西游记是一部浪漫主义杰作	0
电流通过人体吗	为什么孝文帝要改制	0
什么是余音绕梁，三日不绝	什么是余音绕梁三日不绝	1
为什么湖水夏天浑浊，秋天清亮	雾是怎样形成的	0
为什么台风的风眼中没有风	为什么幼儿常常会破涕为笑	0
为什么游泳时必须用嘴吸气	为什么罂粟被称为有毒植物之王	0
什么是贫铀弹	·!!·为什么方承观立志苦学	0
为什么工艺美术深受幼儿园小朋友的喜爱	竹笋为什么有大小年	0
为什么肥胖者要进低热量饮食	什么是词义的扩大和缩小	0
为什么不能把录音机、电视机、录像机放在一起	为什么不能把录音机、电视机、录像机放在一起	1
宇宙是什么样子	宇宙是什么子	1
为什么同一个玉米棒上会有不同颜色的粒	为什么同一个玉米上会有不同颜色的粒	1
为什么小朋友的胳膊容易脱臼	为什么小朋友的膊容易脱臼	1
运动后肌肉酸痛怎么办	为什么狼的眼睛会闪闪发光	0
气压的变化与哪些因素有关	为什么世界上第一把小提琴是埃及的音乐家莫可里制造的	0
为什么水是无色的，雪却是白色的	为什么血能在人体中流动	0
为什么运动场都是南北向的	为什么运场都是南北向的	1
为什么郑板桥能把河中的五彩石夹上来	为什么叫虎门	0
为什么小熊猫总长不大	为什么小熊总长不大	1
人是怎样看见物体的	人是怎样看见物体的	1
为什么要纠正错别字	为什么要纠正错别字	1
为什么下雨前小虫特别多	为什么下雨前小虫特别多	1
为什么瓶子草是食虫的最特殊的植物	有头上长角的鱼吗	0
为什么变压器能改变电压的高低	为什么变压器能改变电压的高低	1
为什么人要睡觉	为什么人要睡	1
为什么春节要敲锣打鼓放鞭炮	为什么小麻雀每天晚上飞来和杨宝做伴	0
为什么叫马跑泉	鹞式战斗机为什么能垂直起降	0
为什么人们把血液看成是生命	为什么人们把血液成是生命	1
红、黄、蓝为什么被称为三原色	红、黄、蓝为什么被称为三原色	1
为什么傈僳族要过刀竿节	为什么人一哭就会流鼻涕	0
为什么蔡和森挨饿也要读书	怎样培养你的音乐细胞	0
为什么火箭要垂直发射	为什么箭要垂直发射	1
为什么八月十五吃月饼	为什么八月十五吃月饼	1
为什么常绿树能变成落叶树	为什么常绿树能变成落叶树	1
美国的导弹防御计划是怎样的	为什么有的幼儿在陌生人和集体面前表现得很胆怵	0
为什么仡佬族人要给牛过生日	为什么仡佬族要给牛过生日	1
为什么跳蚤有惊人的跳跃本领	为什么天空中会出现流星	0
为什么豆子会生虫	为什么奥运会以五色环为标志	0
为什么双双小朋友常出现有意破坏的行为	为什么最热的地方不在赤道	0
为什么话剧演员要必修音乐课	日本庆祝男孩节为什么要挂鲤帜	0
怎样使用互联网	为什么有的音乐叫激光音乐	0
为什么细嫩的幼苗能拱动石板	为什么楚辞能够传唱千古	0
火箭为什么能在太空中飞行	五谷是哪五种农作物	0
为什么物体的重量会变	为什么物体的重量会变	1
为什么说中国是风筝的故乡	为什么藏族人腰间有一个大口袋	0
什么是燃料电池	为什么要让小朋友尽早学会用筷子	0
为什么羌族人的房顶上立着块石英石	为什么会爆发第二次世界大战	0
为什么人们不能直接吃河豚	为什么娜娜会把幼儿园的积木拿回家	0
为什么运动场上要穿钉子鞋	为什么中国画常把彩色的东西画成黑白的	0
为什么说树叶是最简易的吹奏乐器	你知道声乐演唱有哪些形式吗	0
为什么有的鱼离开水不会死	什么是褒义词	0
花生为什么又叫落花生	为什么步枪口径越来越小	0
为什么说海洋和陆地是会变化的	为什么隐形飞机也会有克星	0
毛莱是哪个民族的传统体育项目	男孩子为什么爱意气用事	0
为什么鲸不是鱼	为什么鲸不是鱼	1
被遗弃在太空的尸体最终会怎样	红糖结块怎么办	0
大雪后为什么很寂静	昆虫是怎样保护自己的	0
水果为什么能解酒	为什么会出现战国七雄	0
为什么用x表示未知数	为什么用x表示未知数	1
套马是哪个民族的传统体育项目	乙醇汽油和普通汽油有什么不同	0
为什么要适当地吃粗粮	为什么哈萨克族人要向客人献羊头	0
沙漠是怎样形成的	沙漠是样形成的	1
为什么中医也讲阴阳五行	为什么要让玩具成为孩子的好伙伴	0
为什么侦察机能作空中间谍	为什么已排除的化学地雷应运到安全地点处理	0
为什么汽车玻璃和家用玻璃不一样	鱼雷是怎样击中目标的	0
人为什么会出汗	人为什么会出汗	1
为什么不能在玻璃上滑冰	维吾尔族有什么礼仪、禁忌	0
为什么环卫工人不能烧落叶	为什么傈僳族要过刀竿节	0
为什么把天王星称做冷行星	为什么用流动的水洗手比用盆里水洗手效果要好	0
为什么张溥把自己的书房叫作七录书斋	怎样用比较的方法审题	0
为什么北京有那么多有名和好玩的地方	饺子或肉丸煮熟了为什么会浮起来	0
为什么有些验血项目需要空腹进行	为什么要培养孩子良好的睡眠习惯	0
牛蛙的肤色为什么会改变	清明节为什么是我国的传统节日	0
为什么秦始皇要焚书坑儒	动物为什么不会迷失方向	0
为什么豆子会生虫	为什么叫歌声博物馆	0
为什么珊珊喜欢用粒粒橙汁罐做小娃娃	为什么孝文帝要改制	0
为什么滑水运动员不会沉入水中	为什么滑水运动员不会沉入水中	1
为什么吃了没煮熟的扁豆会中毒	为什么通用机枪多为轻重两用	0
为什么刚掀开的冷冻啤酒瓶口会冒出雾气	为什么要从小预防近视眼	0
为什么地球又叫蓝色的星球	什么地球又叫蓝色的星球	1
为什么会出现战国七雄	号称绿色陷阱的沼泽是怎样形成的	0
为什么鸡和鸭有翅膀却飞不高呢	为什么鸡和鸭有膀却飞不高呢	1
为什么边尔村的泉被称为神泉	为什么用瓶盖做成的小乐器声音很好听	0
为什么幼儿记不住该记的事	胫骨前痛是怎样引起的	0
你了解气门芯吗	猪为什么用嘴巴拱泥土	0
为什么在夏天自行车胎容易放炮	为什么说植物是我们的朋友	0
为什么有的墙用空心砖来砌	独龙族是怎样过卡秋哇节的	0
什么是词义的扩大和缩小	唱歌跑调与情绪有关吗	0
